key	value
GAME_LOADING	Oadinglay...
EXP_COUNTER_MAX	AXmay
MAIN_MENU_BUTTON_SINGLEPLAY	Ingleplayersay
MAIN_MENU_BUTTON_SINGLEPLAY_TOOLTIP	Artstay ayay Ingleplayersay Amegay.
MAIN_MENU_BUTTON_MULTIPLAY	Ultiplayermay
MAIN_MENU_BUTTON_MULTIPLAY_TOOLTIP	Artstay ayay Etplaynay Amegay.
MAIN_MENU_BUTTON_MULTIPLAY_DISABLED_TOOLTIP	Ultiplayermay isyay isabledday onyay isthay emoday.
MAIN_MENU_BUTTON_SETTINGS	Ettingssay
MAIN_MENU_BUTTON_SETTINGS_TOOLTIP	Onfigurecay Amegay Ettingssay.
MAIN_MENU_BUTTON_QUIT	Uitqay
MAIN_MENU_BUTTON_QUIT_TOOLTIP	Endyay Ethay Applicationyay.
CHARACTER_SELECT_HEADER	Aracterchay Electsay
CHARACTER_SELECT_HEADER_GAME_MODE_SINGLEPLAYER	Ingleplayersay
CHARACTER_SELECT_HEADER_GAME_MODE_HOST_MULTIPLAYER_PUBLIC	Osthay Amegay (Ublicpay)
CHARACTER_SELECT_HEADER_GAME_MODE_HOST_MULTIPLAYER_FRIENDS	Osthay Amegay (Iendsfray)
CHARACTER_SELECT_HEADER_GAME_MODE_HOST_MULTIPLAYER_PRIVATE	Osthay Amegay (Ivatepray)
CHARACTER_SELECT_HEADER_GAME_MODE_JOIN_MULTIPLAYER	Oinjay Amegay
CHARACTER_SELECT_HEADER_GAME_MODE_LOBBY_QUERY	Obbylay Ueryqay
CHARACTER_SELECT_BUTTON_CREATE_CHARACTER	Eatecray Aracterchay
CHARACTER_SELECT_BUTTON_DELETE_CHARACTER	Eleteday Aracterchay
CHARACTER_SELECT_BUTTON_SELECT_CHARACTER	Electsay Aracterchay
CHARACTER_SELECT_BUTTON_RETURN	Eturnray
CHARACTER_SELECT_DATA_ENTRY_EMPTY_SLOT	Emptyyay Otslay
FORMAT_CHARACTER_SELECT_DATA_ENTRY_INFO	Lvyay-{0} {1} {2}
CHARACTER_SELECT_CHARACTER_DELETE_PROMPT_TEXT	Etypay inyay ethay aracter'schay amenay otay onfirmcay.
CHARACTER_SELECT_CHARACTER_DELETE_PROMPT_PLACEHOLDER_TEXT	Enteryay Icknamenay...
CHARACTER_SELECT_CHARACTER_DELETE_BUTTON_CONFIRM	Eleteday Aracterchay
CHARACTER_SELECT_CHARACTER_DELETE_BUTTON_RETURN	Eturnray
CHARACTER_CREATION_HEADER	Aracterchay Eationcray
CHARACTER_CREATION_HEADER_RACE_NAME	Aceray Electsay
CHARACTER_CREATION_RACE_DESCRIPTOR_HEADER_INITIAL_SKILL	Initialyay Illskay
CHARACTER_CREATION_BUTTON_SET_TO_DEFAULTS	Efaultsday
CHARACTER_CREATION_CHARACTER_NAME_PLACEHOLDER_TEXT	Enteryay Amenay...
CHARACTER_CREATION_BUTTON_CREATE_CHARACTER	Eatecray Aracterchay
CHARACTER_CREATION_BUTTON_RETURN	Eturnray
CHARACTER_CREATION_CUSTOMIZER_HEADER_COLOR	Olorcay
CHARACTER_CREATION_CUSTOMIZER_COLOR_BODY_HEADER	Odybay
CHARACTER_CREATION_CUSTOMIZER_COLOR_BODY_TEXTURE	Exturetay
CHARACTER_CREATION_CUSTOMIZER_COLOR_HAIR_HEADER	Airhay
CHARACTER_CREATION_CUSTOMIZER_COLOR_HAIR_LOCK_COLOR	Ocklay Olorcay
CHARACTER_CREATION_CUSTOMIZER_HEADER_HEAD	Eadhay
CHARACTER_CREATION_CUSTOMIZER_HEAD_HEAD_WIDTH	Eadhay Idthway
CHARACTER_CREATION_CUSTOMIZER_HEAD_HEAD_MOD	Odifymay
CHARACTER_CREATION_CUSTOMIZER_HEAD_VOICE_PITCH	Oicevay Itchpay
CHARACTER_CREATION_CUSTOMIZER_HEAD_HAIR_STYLE	Airhay
CHARACTER_CREATION_CUSTOMIZER_HEAD_EARS	Earsyay
CHARACTER_CREATION_CUSTOMIZER_HEAD_EYES	Eyesyay
CHARACTER_CREATION_CUSTOMIZER_HEAD_MOUTH	Outhmay
CHARACTER_CREATION_CUSTOMIZER_HEADER_BODY	Odybay
CHARACTER_CREATION_CUSTOMIZER_BODY_HEIGHT	Eighthay
CHARACTER_CREATION_CUSTOMIZER_BODY_WIDTH	Idthway
CHARACTER_CREATION_CUSTOMIZER_BODY_CHEST	Estchay
CHARACTER_CREATION_CUSTOMIZER_BODY_ARMS	Armsyay
CHARACTER_CREATION_CUSTOMIZER_BODY_BELLY	Ellybay
CHARACTER_CREATION_CUSTOMIZER_BODY_BOTTOM	Ottombay
CHARACTER_CREATION_CUSTOMIZER_BODY_TAIL	Ailtay
CHARACTER_CREATION_CUSTOMIZER_BODY_TOGGLE_LEFT_HANDED	Irrormay Odybay
CHARACTER_CREATION_CUSTOMIZER_HEADER_TRAIT	Aittray
CHARACTER_CREATION_CUSTOMIZER_TRAIT_EQUIPMENT	Equipmentyay
CHARACTER_CREATION_CUSTOMIZER_TRAIT_WEAPON_LOADOUT	Eaponway
CHARACTER_CREATION_CUSTOMIZER_TRAIT_GEAR_DYE	Edyay
CHARACTER_CREATION_CUSTOMIZER_TRAIT_ATTRIBUTES	Attributesyay
CHARACTER_CREATION_CUSTOMIZER_TRAIT_RESET_ATTRIBUTE_POINTS	Esetray Ointspay
SETTINGS_TAB_BUTTON_VIDEO	Isplayday
SETTINGS_TAB_BUTTON_AUDIO	Audioyay
SETTINGS_TAB_BUTTON_INPUT	Inputyay
SETTINGS_TAB_BUTTON_NETWORK	Interfaceyay
SETTINGS_VIDEO_HEADER_GAME_EFFECT_SETTINGS	Isplayday Ensitivesay Ettingssay
SETTINGS_VIDEO_CELL_PROPORTIONS_TOGGLE	Imitlay Ayerplay Aracterchay Oportionspray
SETTINGS_VIDEO_CELL_JIGGLE_BONES_TOGGLE	Isableday Uggestivesay Igglejay Onesbay
SETTINGS_VIDEO_CELL_CLEAR_UNDERCLOTHES_TOGGLE	Enableyay Earclay Othingclay
SETTINGS_VIDEO_HEADER_VIDEO_SETTINGS	Ideovay Ettingssay
SETTINGS_VIDEO_CELL_FULLSCREEN_TOGGLE	Ullscreenfay Odemay
SETTINGS_VIDEO_CELL_VERTICAL_SYNC	Erticalvay Syncyay / Ocklay 60 FPSyay
SETTINGS_VIDEO_CELL_ANISOTROPIC_FILTERING	Anisotropicyay Ilteringfay
SETTINGS_VIDEO_CELL_SCREEN_RESOLUTION	Eenscray Esolutionray
SETTINGS_VIDEO_CELL_ANTI_ALIASING	Antiyay Aliasingyay
SETTINGS_VIDEO_CELL_ANTI_ALIASING_OPTION_1	Isabledday
SETTINGS_VIDEO_CELL_ANTI_ALIASING_OPTION_2	2xyay Ultimay Amplingsay
SETTINGS_VIDEO_CELL_ANTI_ALIASING_OPTION_3	4xyay Ultimay Amplingsay
SETTINGS_VIDEO_CELL_ANTI_ALIASING_OPTION_4	8xyay Ultimay Amplingsay
SETTINGS_VIDEO_CELL_TEXTURE_FILTERING	Exturetay Ilteringfay
SETTINGS_VIDEO_CELL_TEXTURE_FILTERING_OPTION_1	Ilnearbay (Oothsmay)
SETTINGS_VIDEO_CELL_TEXTURE_FILTERING_OPTION_2	Earestnay (Unchycray)
SETTINGS_VIDEO_CELL_TEXTURE_QUALITY	Exturetay Ualityqay
SETTINGS_VIDEO_CELL_TEXTURE_QUALITY_OPTION_1	Ighhay
SETTINGS_VIDEO_CELL_TEXTURE_QUALITY_OPTION_2	Ediummay
SETTINGS_VIDEO_CELL_TEXTURE_QUALITY_OPTION_3	Owlay
SETTINGS_VIDEO_CELL_TEXTURE_QUALITY_OPTION_4	Eryvay Owlay
SETTINGS_VIDEO_HEADER_CAMERA_SETTINGS	Ameracay Isplayday Ettingssay
SETTINGS_VIDEO_CELL_FIELD_OF_VIEW	Ieldfay Ofyay Iewvay
SETTINGS_VIDEO_CELL_CAMERA_SMOOTHING	Ameracay Oothingsmay
SETTINGS_VIDEO_CELL_CAMERA_HORIZ	Ameracay Xyay Ositionpay
SETTINGS_VIDEO_CELL_CAMERA_VERT	Ameracay Yyay Ositionpay
SETTINGS_VIDEO_CELL_CAMERA_RENDER_DISTANCE	Enderray Istanceday
SETTINGS_VIDEO_CELL_CAMERA_RENDER_DISTANCE_OPTION_1	Eryvay Earnay
SETTINGS_VIDEO_CELL_CAMERA_RENDER_DISTANCE_OPTION_2	Earnay
SETTINGS_VIDEO_CELL_CAMERA_RENDER_DISTANCE_OPTION_3	Arfay
SETTINGS_VIDEO_CELL_CAMERA_RENDER_DISTANCE_OPTION_4	Eryvay Arfay
SETTINGS_VIDEO_HEADER_POST_PROCESSING	Ostpay Ocessingpray
SETTINGS_VIDEO_CELL_CAMERA_BITCRUSH_SHADER	Enableyay Itcrushbay Adershay
SETTINGS_VIDEO_CELL_CAMERA_WATER_EFFECT	Enableyay Underwateryay Istortionday Adershay
SETTINGS_VIDEO_CELL_CAMERA_SHAKE	Enableyay Eenscray Akeshay
SETTINGS_VIDEO_CELL_WEAPON_GLOW	Isableday Eaponway Owglay Effectyay
SETTINGS_AUDIO_HEADER_AUDIO_SETTINGS	Audioyay Ettingssay
SETTINGS_AUDIO_CELL_MASTER_VOLUME	Astermay Olumevay
SETTINGS_AUDIO_CELL_MUTE_APPLICATION	Utemay Applicationyay
SETTINGS_AUDIO_CELL_MUTE_MUSIC	Utemay Usicmay
SETTINGS_AUDIO_HEADER_AUDIO_CHANNEL_SETTINGS	Audioyay Annelschay
SETTINGS_AUDIO_CELL_GAME_VOLUME	Amegay Olumevay
SETTINGS_AUDIO_CELL_GUI_VOLUME	UIgay Olumevay
SETTINGS_AUDIO_CELL_AMBIENCE_VOLUME	Ambienceyay Olumevay
SETTINGS_AUDIO_CELL_MUSIC_VOLUME	Usicmay Olumevay
SETTINGS_AUDIO_CELL_VOICE_VOLUME	Oicevay Olumevay
SETTINGS_INPUT_HEADER_INPUT_SETTINGS	Inputyay Ettingssay
SETTINGS_INPUT_CELL_AXIS_TYPE	Analogyay Ickstay Axisyay Etypay
SETTINGS_INPUT_CELL_AXIS_TYPE_OPTION_1	ASDway (8 Irectionalday)
SETTINGS_INPUT_CELL_AXIS_TYPE_OPTION_2	Oxxbay
SETTINGS_INPUT_CELL_AXIS_TYPE_OPTION_3	Aystationplay 4
SETTINGS_INPUT_HEADER_CAMERA_CONTROL	Ameracay Ontrolcay
SETTINGS_INPUT_CELL_CAMERA_SENSITIVITY	Axisyay Ensitivitysay
SETTINGS_INPUT_CELL_INVERT_X_CAMERA_AXIS	Invertyay Xyay Axisyay
SETTINGS_INPUT_CELL_INVERT_Y_CAMERA_AXIS	Invertyay Yyay Axisyay
SETTINGS_INPUT_CELL_KEYBINDING_RESET_CAMERA	Esetray Ameracay
SETTINGS_INPUT_HEADER_MOVEMENT	Ovementmay
SETTINGS_INPUT_CELL_KEYBINDING_UP	Upyay
SETTINGS_INPUT_CELL_KEYBINDING_DOWN	Ownday
SETTINGS_INPUT_CELL_KEYBINDING_LEFT	Eftlay
SETTINGS_INPUT_CELL_KEYBINDING_RIGHT	Ightray
SETTINGS_INPUT_CELL_KEYBINDING_JUMP	Umpjay
SETTINGS_INPUT_CELL_KEYBINDING_DASH	Ashday
SETTINGS_INPUT_HEADER_STRAFING	Afingstray
SETTINGS_INPUT_CELL_KEYBINDING_LOCK_DIRECTION	Afestray
SETTINGS_INPUT_CELL_KEYBINDING_STRAFE_MODE	Afestray / Aimyay Odemay
SETTINGS_INPUT_CELL_KEYBINDING_STRAFE_MODE_OPTION_1	Oldhay Afestray Eykay
SETTINGS_INPUT_CELL_KEYBINDING_STRAFE_MODE_OPTION_2	Oggletay Afestray Eykay
SETTINGS_INPUT_CELL_KEYBINDING_STRAFE_WEAPON	Afestray Ilewhay Oldinghay Eaponway
SETTINGS_INPUT_CELL_KEYBINDING_STRAFE_CASTING	Afestray Ilewhay Astingcay Offensiveyay Illsskay
SETTINGS_INPUT_HEADER_ACTION	Actionyay
SETTINGS_INPUT_CELL_KEYBINDING_ATTACK	Attackyay
SETTINGS_INPUT_CELL_KEYBINDING_CHARGE_ATTACK	Argechay Attackyay
SETTINGS_INPUT_CELL_KEYBINDING_BLOCK	Ockblay
SETTINGS_INPUT_CELL_KEYBINDING_TARGET	Ocklay Onyay
SETTINGS_INPUT_CELL_KEYBINDING_INTERACT	Interactyay
SETTINGS_INPUT_CELL_KEYBINDING_PVP_FLAG	PvPyay Agflay Oggletay
SETTINGS_INPUT_CELL_KEYBINDING_SKILL_SLOT_01	Illskay Otslay 1
SETTINGS_INPUT_CELL_KEYBINDING_SKILL_SLOT_02	Illskay Otslay 2
SETTINGS_INPUT_CELL_KEYBINDING_SKILL_SLOT_03	Illskay Otslay 3
SETTINGS_INPUT_CELL_KEYBINDING_SKILL_SLOT_04	Illskay Otslay 4
SETTINGS_INPUT_CELL_KEYBINDING_SKILL_SLOT_05	Illskay Otslay 5
SETTINGS_INPUT_CELL_KEYBINDING_SKILL_SLOT_06	Illskay Otslay 6
SETTINGS_INPUT_CELL_KEYBINDING_RECALL	Ecallray
SETTINGS_INPUT_CELL_KEYBINDING_QUICKSWAP_WEAPON	Uickswapqay Eaponway
SETTINGS_INPUT_CELL_KEYBINDING_SHEATHE_WEAPON	Eatheshay / Unsheatheyay Eaponway
SETTINGS_INPUT_CELL_KEYBINDING_SIT	Itsay
SETTINGS_INPUT_HEADER_CONSUMABLE_SLOTS	Onsumablecay Uickqay Otsslay
SETTINGS_INPUT_CELL_KEYBINDING_QUICK_SLOT_01	Uickqay Otslay 1
SETTINGS_INPUT_CELL_KEYBINDING_QUICK_SLOT_02	Uickqay Otslay 2
SETTINGS_INPUT_CELL_KEYBINDING_QUICK_SLOT_03	Uickqay Otslay 3
SETTINGS_INPUT_CELL_KEYBINDING_QUICK_SLOT_04	Uickqay Otslay 4
SETTINGS_INPUT_CELL_KEYBINDING_QUICK_SLOT_05	Uickqay Otslay 5
SETTINGS_INPUT_HEADER_INTERFACE	Interfaceyay
SETTINGS_INPUT_CELL_KEYBINDING_HOST_CONSOLE	Osthay Onsolecay
SETTINGS_INPUT_CELL_KEYBINDING_LEXICON	Openyay Exiconlay
SETTINGS_INPUT_CELL_KEYBINDING_TAB_MENU	Openyay Abtay Enumay
SETTINGS_INPUT_CELL_KEYBINDING_STATS_TAB	Atsstay Abtay
SETTINGS_INPUT_CELL_KEYBINDING_SKILLS_TAB	Illsskay Abtay
SETTINGS_INPUT_CELL_KEYBINDING_ITEM_TAB	Itemyay Abtay
SETTINGS_INPUT_CELL_KEYBINDING_QUEST_TAB	Uestqay Abtay
SETTINGS_INPUT_CELL_KEYBINDING_WHO_TAB	Owhay Abtay
SETTINGS_INPUT_CELL_KEYBINDING_HIDE_UI	Idehay Amegay UIyay
SETTINGS_NETWORK_HEADER_UI_SETTINGS	UIyay Ettingssay
SETTINGS_NETWORK_CELL_LOCALYSSATION_LANGUAGE	Anguagelay
SETTINGS_NETWORK_CELL_DISPLAY_CREEP_NAMETAGS	Isplayday Enemyyay Ametagsnay
SETTINGS_NETWORK_CELL_DISPLAY_LOCAL_NAMETAG	Isplayday Ocallay Aracterchay Amenay Agtay
SETTINGS_NETWORK_CELL_DISPLAY_HOST_TAG	Isplayday [OSThay] Agtay onyay Osthay Aracterchay
SETTINGS_NETWORK_CELL_HIDE_DUNGEON_MINIMAP	Idehay Ungeonday Inimapmay
SETTINGS_NETWORK_CELL_HIDE_FPS_COUNTER	Idehay FPSyay Ountercay
SETTINGS_NETWORK_CELL_HIDE_PING_COUNTER	Idehay Ingpay Ountercay
SETTINGS_NETWORK_HEADER_CLIENT_SETTINGS	Ientclay Ettingssay
SETTINGS_NETWORK_CELL_ENABLE_PVP_ON_MAP_ENTER	Agflay orfay PvPyay enwhay availableyay
SETTINGS_BUTTON_RESET_TO_DEFAULTS	Esetray otay Efaultsday
SETTINGS_BUTTON_RESET	Esetray
SETTINGS_BUTTON_CANCEL	Ancelcay
SETTINGS_BUTTON_APPLY	Applyyay
FORMAT_EQUIP_ITEM_RARITY	[{0}]
FORMAT_EQUIP_LEVEL_REQUIREMENT	Lvyay-{0}
FORMAT_EQUIP_CLASS_REQUIREMENT	Assclay: {0}
FORMAT_EQUIP_WEAPON_CONDITION	\n<color=lime>- <color=yellow>{0}%</color> ancechay otay applyyay {1}.</color>
EQUIP_TOOLTIP_TYPE_HELM	Elmhay (Armoryay)
EQUIP_TOOLTIP_TYPE_CHESTPIECE	Estpiecechay (Armoryay)
EQUIP_TOOLTIP_TYPE_LEGGINGS	Eggingslay (Armoryay)
EQUIP_TOOLTIP_TYPE_CAPE	Apecay (Armoryay)
EQUIP_TOOLTIP_TYPE_RING	Ingray (Armoryay)
FORMAT_EQUIP_TOOLTIP_TYPE_WEAPON	{0} (Eaponway)
EQUIP_TOOLTIP_TYPE_SHIELD	Ieldshay
FORMAT_EQUIP_STATS_DAMAGE_SCALED	<color=#c5e384>({0} - {1})</color> Amageday
FORMAT_EQUIP_STATS_DAMAGE_SCALED_POWERFUL	<color=#efcc00>({0} - {1})</color> Amageday
FORMAT_EQUIP_STATS_DAMAGE_COMPARE_BASE	\n<color=grey>(Asebay Amageday: {0} - {1})</color>
FORMAT_EQUIP_STATS_DAMAGE_UNSCALED	({0} - {1}) Amageday
FORMAT_EQUIP_STATS_BLOCK_THRESHOLD	Ockblay esholdthray: {0} amageday
TAB_MENU_CELL_STATS_HEADER	Atsstay
TAB_MENU_CELL_STATS_ATTRIBUTE_POINT_COUNTER	Ointspay
TAB_MENU_CELL_STATS_BUTTON_APPLY_ATTRIBUTE_POINTS	Applyyay
TAB_MENU_CELL_STATS_INFO_CELL_NICK_NAME	Icknamenay
TAB_MENU_CELL_STATS_INFO_CELL_RACE_NAME	Aceray
TAB_MENU_CELL_STATS_INFO_CELL_CLASS_NAME	Assclay
TAB_MENU_CELL_STATS_INFO_CELL_LEVEL_COUNTER	Evellay
TAB_MENU_CELL_STATS_INFO_CELL_EXPERIENCE	Experienceyay
TAB_MENU_CELL_STATS_INFO_CELL_MAX_HEALTH	Ealthhay
TAB_MENU_CELL_STATS_INFO_CELL_MAX_MANA	Anamay
TAB_MENU_CELL_STATS_INFO_CELL_MAX_STAMINA	Aminastay
TAB_MENU_CELL_STATS_INFO_CELL_ATTACK	Attackyay Owerpay
TAB_MENU_CELL_STATS_INFO_CELL_RANGED_POWER	Exday Owerpay
TAB_MENU_CELL_STATS_INFO_CELL_PHYS_CRITICAL	Physyay. Itcray %
TAB_MENU_CELL_STATS_INFO_CELL_MAGIC_POW	Mgkyay. Owerpay
TAB_MENU_CELL_STATS_INFO_CELL_MAGIC_CRIT	Mgkyay. Itcray %
TAB_MENU_CELL_STATS_INFO_CELL_DEFENSE	Efenseday
TAB_MENU_CELL_STATS_INFO_CELL_MAGIC_DEF	Mgkyay. Efenseday
TAB_MENU_CELL_STATS_INFO_CELL_EVASION	Evasionyay %
TAB_MENU_CELL_STATS_INFO_CELL_MOVE_SPD	Ovmay Spdyay %
TAB_MENU_CELL_STATS_TOOLTIP_BASE_STAT_BEGIN	<b>Asebay Atstay:</b> <i>
TAB_MENU_CELL_STATS_TOOLTIP_BASE_STAT_END_CRIT	%</i> (Iticalcray %)
TAB_MENU_CELL_STATS_TOOLTIP_BASE_STAT_END_EVASION	%</i> (Evasionyay %)
TAB_MENU_CELL_STATS_TOOLTIP_BASE_STAT_FORMAT_ATTACK_POW	{0}</i> (Attackyay Owerpay)
TAB_MENU_CELL_STATS_TOOLTIP_BASE_STAT_FORMAT_MAX_MP	{0}</i> (Axmay Anamay)
TAB_MENU_CELL_STATS_TOOLTIP_BASE_STAT_FORMAT_MAX_HP	{0}</i> (Axmay Ealthhay)
TAB_MENU_CELL_STATS_TOOLTIP_BASE_STAT_FORMAT_RANGE_POW	{0}</i> (Exday Owerpay)
TAB_MENU_CELL_STATS_TOOLTIP_BASE_STAT_END_MAGIC_CRIT	%</i> (Agicmay Iticalcray %)
TAB_MENU_CELL_STATS_TOOLTIP_BASE_STAT_FORMAT_MAGIC_DEF	{0}</i> (Agicmay Efenseday)
TAB_MENU_CELL_STATS_TOOLTIP_BASE_STAT_FORMAT_DEFENSE	{0}</i> (Efenseday)
TAB_MENU_CELL_STATS_TOOLTIP_BASE_STAT_FORMAT_MAGIC_POW	{0}</i> (Agicmay Owerpay)
TAB_MENU_CELL_STATS_TOOLTIP_BASE_STAT_FORMAT_MAX_STAM	{0}</i> (Axmay Aminastay)
FORMAT_QUEST_REQUIRED_LEVEL	(lvyay-{0})
QUEST_TYPE_CLASS	(Assclay Ometay)
QUEST_TYPE_MASTERY	(Asterymay Ollscray)
QUEST_MENU_SUMMARY_NO_QUESTS	Onay Uestsqay inyay Uestqay Oglay.
QUEST_MENU_HEADER_UNSELECTED	Electsay ayay Uestqay.
FORMAT_QUEST_MENU_CELL_QUEST_LOG_COUNTER	Uestqay Oglay: ({0} / {1})
FORMAT_QUEST_MENU_CELL_FINISHED_QUEST_COUNTER	Ompletedcay Uestsqay: {0}
FORMAT_QUEST_MENU_CELL_REWARD_EXP	{0} expyay
FORMAT_QUEST_MENU_CELL_REWARD_CURRENCY	{0} Ownscray
QUEST_MENU_CELL_SLOT_EMPTY	Emptyyay Otslay
QUEST_SELECTION_MANAGER_QUEST_ACCEPT_BUTTON_ACCEPT	Acceptyay Uestqay
QUEST_SELECTION_MANAGER_QUEST_ACCEPT_BUTTON_LOCKED	Uestqay Ockedlay
QUEST_SELECTION_MANAGER_QUEST_ACCEPT_BUTTON_INCOMPLETE	Uestqay Incompleteyay
QUEST_SELECTION_MANAGER_QUEST_ACCEPT_BUTTON_TURN_IN	Ompletecay Uestqay
QUEST_SELECTION_MANAGER_QUEST_ACCEPT_BUTTON_UNSELECTED	Electsay ayay Uestqay
FORMAT_QUEST_PROGRESS	{0}: ({1} / {2})
FORMAT_QUEST_PROGRESS_CREEPS_KILLED	{0} ainslay
ITEM_LEATHER_CAP_NAME	Eatherlay Apcay
ITEM_LEATHER_CAP_DESCRIPTION	
ITEM_NEWFOLD_HALO_NAME	Ewfoldnay Alohay
ITEM_NEWFOLD_HALO_DESCRIPTION	Ayay igilsay otay indicateyay ayay ewnay oul'ssay introductionyay otay ethay orldway.
ITEM_FOCUS_CIRCLET_NAME	Ocusfay Ircletcay
ITEM_FOCUS_CIRCLET_DESCRIPTION	Eepkay illstay.
ITEM_JOURNEYMAN_SPECTACLES_NAME	Ourneymanjay Ectaclesspay
ITEM_JOURNEYMAN_SPECTACLES_DESCRIPTION	Usedyay otay eadray arderhay-- ownay ithway olorcay!
ITEM_MAGISTRATE_CIRCLET_NAME	Agistratemay Ircletcay
ITEM_MAGISTRATE_CIRCLET_DESCRIPTION	Earsclay ethay indmay, uttingpay ingsthay atyay easeyay.
ITEM_RAGE_CIRCLET_NAME	Ageray Ircletcay
ITEM_RAGE_CIRCLET_DESCRIPTION	Ervorfay ofyay angstyay andyay envyyay.
ITEM_GEISTLORD_CROWN_NAME	Eistlordgay Owncray
ITEM_GEISTLORD_CROWN_DESCRIPTION	Ancay ouyay andlehay ethay adnessmay atthay ensuesyay?
ITEM_NETHERCRYPT_HALO_NAME	Ethercryptnay Alohay
ITEM_NETHERCRYPT_HALO_DESCRIPTION	Anishedbay owncray omfray ethay ethernay ealmsray.
ITEM_MITHRIL_HALO_NAME	Ithrilmay Alohay
ITEM_MITHRIL_HALO_DESCRIPTION	
ITEM_GLYPHGRIFT_HALO_NAME	Iftglyphgray Alohay
ITEM_GLYPHGRIFT_HALO_DESCRIPTION	
ITEM_JESTERCAST_MEMORY_NAME	Estercastjay Emorymay
ITEM_JESTERCAST_MEMORY_DESCRIPTION	Ethay uetray oolfay isyay ethay enemyyay ofyay ethay astercay...
ITEM_KNIGHTGUARD_HALO_NAME	Ightguardknay Alohay
ITEM_KNIGHTGUARD_HALO_DESCRIPTION	Isionsvay ofyay ightmay andyay owesspray.
ITEM_GEISTLORD_EYE_NAME	Eistlordgay Eyeyay
ITEM_GEISTLORD_EYE_DESCRIPTION	Adnessmay eyondbay omprehensioncay.
ITEM_INITIATE_SPECTACLES_NAME	Initiateyay Ectaclesspay
ITEM_INITIATE_SPECTACLES_DESCRIPTION	Usedyay otay eadray.
ITEM_CRYPTSINGE_HALO_NAME	Ingecryptsay Alohay
ITEM_CRYPTSINGE_HALO_DESCRIPTION	Uminationray ofyay ethay eadday.
ITEM_DIVA_CROWN_NAME	Ivaday Owncray
ITEM_DIVA_CROWN_DESCRIPTION	Ayay owncray ornway byyay ayay Imeslay Ivaday. Ontainscay unusualyay owerpay.
ITEM_IRON_HALO_NAME	Ironyay Alohay
ITEM_IRON_HALO_DESCRIPTION	
ITEM_DEMICRYPT_HALO_NAME	Emicryptday Alohay
ITEM_DEMICRYPT_HALO_DESCRIPTION	Allenfay omfray orruptedcay angelsyay.
ITEM_ACOLYTE_HOOD_NAME	Acolyteyay Oodhay
ITEM_ACOLYTE_HOOD_DESCRIPTION	Ultistscay areyay eensay otay earway isthay.
ITEM_DIRE_HELM_NAME	Ireday Elmhay
ITEM_DIRE_HELM_DESCRIPTION	Onceyay ornway byyay ayay avebray arriorway.
ITEM_WIZARD_HAT_NAME	Izardway Athay
ITEM_WIZARD_HAT_DESCRIPTION	
ITEM_REGAZUUL_CAPE_NAME	Egazuulray Apecay
ITEM_REGAZUUL_CAPE_DESCRIPTION	Ayay onglay orgottenfay eirloomhay ofyay Ordlay Uulnerudazay.
ITEM_COZY_CLOAK_NAME	Ozycay Oakclay
ITEM_COZY_CLOAK_DESCRIPTION	Eepskay ouyay armway inyay ethay oldcay eatherway.
ITEM_NETHERCRYPT_CLOAK_NAME	Ethercryptnay Oakclay
ITEM_NETHERCRYPT_CLOAK_DESCRIPTION	Ugray orfay ethay eetfay ofyay ethay eadday.
ITEM_FORLORN_CLOAK_NAME	Orlornfay Oakclay
ITEM_FORLORN_CLOAK_DESCRIPTION	Oreverfay ostlay.
ITEM_MESHLINK_CAPE_NAME	Eshlinkmay Apecay
ITEM_MESHLINK_CAPE_DESCRIPTION	Evasiveyay andyay ightlay.
ITEM_SAGECALLER_CAPE_NAME	Agecallersay Apecay
ITEM_SAGECALLER_CAPE_DESCRIPTION	Immingbray ithway agicalmay owerpay.
ITEM_COBBLERAGE_CLOAK_NAME	Obbleragecay Oakclay
ITEM_COBBLERAGE_CLOAK_DESCRIPTION	Ouyay eelfay ongstray ikelay ayay olemgay earingway isthay.
ITEM_DEATHWARD_CAPE_NAME	Eathwardday Apecay
ITEM_DEATHWARD_CAPE_DESCRIPTION	Ouyay ancay earhay ethay aughterlay omfray ethay ullskay otifmay.
ITEM_INITIATE_CLOAK_NAME	Initiateyay Oakclay
ITEM_INITIATE_CLOAK_DESCRIPTION	Ewnay eginningsbay.
ITEM_NOKKET_CLOAK_NAME	Okketnay Oakclay
ITEM_NOKKET_CLOAK_DESCRIPTION	
ITEM_RUGGED_CLOAK_NAME	Uggedray Oakclay
ITEM_RUGGED_CLOAK_DESCRIPTION	
ITEM_AERO_TOP_NAME	Aeroyay Optay
ITEM_AERO_TOP_DESCRIPTION	Ommoncay othingclay ornway byyay Esbyrdlay.
ITEM_BUNHOST_GARB_NAME	Unhostbay Arbgay
ITEM_BUNHOST_GARB_DESCRIPTION	
ITEM_LEATHER_TOP_NAME	Eatherlay Optay
ITEM_LEATHER_TOP_DESCRIPTION	Ommoncay othingclay ornway byyay Oonspay.
ITEM_NECRO_MARROW_NAME	Ecronay Arrowmay
ITEM_NECRO_MARROW_DESCRIPTION	Ommoncay othingclay ornway byyay Impsyay.
ITEM_NOBLE_SHIRT_NAME	Oblenay Irtshay
ITEM_NOBLE_SHIRT_DESCRIPTION	
ITEM_NUTSO_TOP_NAME	Utsonay Optay
ITEM_NUTSO_TOP_DESCRIPTION	Ommoncay othingclay ornway byyay Angchay.
ITEM_SAGECLOTH_TOP_NAME	Ageclothsay Optay
ITEM_SAGECLOTH_TOP_DESCRIPTION	Ommoncay othingclay ornway byyay Uboldskay.
ITEM_SILKEN_TOP_NAME	Ilkensay Optay
ITEM_SILKEN_TOP_DESCRIPTION	Ancientyay ilksay othclay. Isthay ould'vecay eenbay aroundyay incesay ethay eryvay eginningbay ofyay imetay...
ITEM_TEST_CHESTPIECE_NAME	Esttay Estpiecechay
ITEM_TEST_CHESTPIECE_DESCRIPTION	Usedyay otay esttay exturingtay.
ITEM_VAMPIRIC_COAT_NAME	Ampiricvay Oatcay
ITEM_VAMPIRIC_COAT_DESCRIPTION	
ITEM_DUELIST_GARB_NAME	Uelistday Arbgay
ITEM_DUELIST_GARB_DESCRIPTION	
ITEM_TATTERED_BATTLEROBE_NAME	Atteredtay Attlerobebay
ITEM_TATTERED_BATTLEROBE_DESCRIPTION	
ITEM_WARRIOR_CHEST_NAME	Arriorway Estchay
ITEM_WARRIOR_CHEST_DESCRIPTION	
ITEM_SLEEPERS_ROBE_NAME	Eeper'sslay Oberay
ITEM_SLEEPERS_ROBE_DESCRIPTION	Osay iredtay...
ITEM_LORD_BREASTPLATE_NAME	Ordlay Eastplatebray
ITEM_LORD_BREASTPLATE_DESCRIPTION	Ailhay ethay Ordlay!
ITEM_REAPSOW_GARB_NAME	Eapsowray Arbgay
ITEM_REAPSOW_GARB_DESCRIPTION	Earfay ethay iddenhay.
ITEM_WITCHLOCK_ROBE_NAME	Itchlockway Oberay
ITEM_WITCHLOCK_ROBE_DESCRIPTION	Oberay ofyay ethay eliteyay occultyay.
ITEM_GOLEM_CHESTPIECE_NAME	Olemgay Estpiecechay
ITEM_GOLEM_CHESTPIECE_DESCRIPTION	
ITEM_NETHERCRYPT_TABARD_NAME	Ethercryptnay Abardtay
ITEM_NETHERCRYPT_TABARD_DESCRIPTION	
ITEM_ORNAMENTED_BATTLEROBE_NAME	Ornamentedyay Attlerobebay
ITEM_ORNAMENTED_BATTLEROBE_DESCRIPTION	
ITEM_MERCENARY_VESTMENT_NAME	Ercenarymay Estmentvay
ITEM_MERCENARY_VESTMENT_DESCRIPTION	
ITEM_MITHRIL_CHESTPIECE_NAME	Ithrilmay Estpiecechay
ITEM_MITHRIL_CHESTPIECE_DESCRIPTION	
ITEM_CARBUNCLE_ROBE_NAME	Arbunclecay Oberay
ITEM_CARBUNCLE_ROBE_DESCRIPTION	Ethay atternspay onyay ethay othclay akemay anyay audibleyay umhay ifyay ouyay istenlay oselyclay.
ITEM_FORTIFIED_VESTMENT_NAME	Ortifiedfay Estmentvay
ITEM_FORTIFIED_VESTMENT_DESCRIPTION	
ITEM_CHAINSCALE_CHEST_NAME	Ainscalechay Estchay
ITEM_CHAINSCALE_CHEST_DESCRIPTION	
ITEM_GEMVEIL_RAIMENT_NAME	Emveilgay Aimentray
ITEM_GEMVEIL_RAIMENT_DESCRIPTION	Azzlingday emsgay ickerflay onyay isthay ooselay utbay efensiveday estpiecechay.
ITEM_KING_BREASTPLATE_NAME	Ingkay Eastplatebray
ITEM_KING_BREASTPLATE_DESCRIPTION	Endbay ethay eeknay, otay ethay Ingkay!
ITEM_MONOLITH_CHESTPIECE_NAME	Onolithmay Estpiecechay
ITEM_MONOLITH_CHESTPIECE_DESCRIPTION	
ITEM_REAPER_GI_NAME	Eaperray Igay
ITEM_REAPER_GI_DESCRIPTION	Ornway byyay undeadyay assassinsyay.
ITEM_WITCHWIZARD_ROBE_NAME	Itchwizardway Oberay
ITEM_WITCHWIZARD_ROBE_DESCRIPTION	Oberay ofyay ethay igherhay eliteyay occultyay.
ITEM_SLIMECRUST_CHEST_NAME	Imecrustslay Estchay
ITEM_SLIMECRUST_CHEST_DESCRIPTION	Ackedcray andyay avagedray byyay imeslay.
ITEM_WORN_ROBE_NAME	Ornway Oberay
ITEM_WORN_ROBE_DESCRIPTION	Efinitelyday eenbay ornway anymay imestay.
ITEM_CHAINMAIL_GUARD_NAME	Ainmailchay Uardgay
ITEM_CHAINMAIL_GUARD_DESCRIPTION	
ITEM_BERSERKER_CHESTPIECE_NAME	Erserkerbay Estpiecechay
ITEM_BERSERKER_CHESTPIECE_DESCRIPTION	
ITEM_FUGUEFALL_DUSTER_NAME	Uguefallfay Usterday
ITEM_FUGUEFALL_DUSTER_DESCRIPTION	
ITEM_MAGILORD_OVERALLS_NAME	Agilordmay Overallsyay
ITEM_MAGILORD_OVERALLS_DESCRIPTION	Evoutday icmystay agessay ofyay ancientyay imestay ornway esethay inyay eremoniescay.
ITEM_JOURNEYMAN_VEST_NAME	Ourneymanjay Estvay
ITEM_JOURNEYMAN_VEST_DESCRIPTION	
ITEM_POACHER_CLOTH_NAME	Oacherpay Othclay
ITEM_POACHER_CLOTH_DESCRIPTION	Ightlyslay eiledvay.
ITEM_GHOSTLY_TABARD_NAME	Ostlyghay Abardtay
ITEM_GHOSTLY_TABARD_DESCRIPTION	
ITEM_CRYPTSINGE_CHEST_NAME	Ingecryptsay Estchay
ITEM_CRYPTSINGE_CHEST_DESCRIPTION	
ITEM_SLIMEK_CHEST_NAME	Imekslay Estchay
ITEM_SLIMEK_CHEST_DESCRIPTION	Urdystay enoughyay otay idthstandway omesay urtherfay amageday.
ITEM_IRON_CHESTPIECE_NAME	Ironyay Estpiecechay
ITEM_IRON_CHESTPIECE_DESCRIPTION	
ITEM_AERO_PANTS_NAME	Aeroyay Antspay
ITEM_AERO_PANTS_DESCRIPTION	Ommoncay othingclay ornway byyay Esbyrdlay.
ITEM_BUNHOST_LEGGINGS_NAME	Unhostbay Eggingslay
ITEM_BUNHOST_LEGGINGS_DESCRIPTION	
ITEM_LEATHER_BRITCHES_NAME	Eatherlay Itchesbray
ITEM_LEATHER_BRITCHES_DESCRIPTION	Ommoncay othingclay ornway byyay Oonspay.
ITEM_NECRO_CAUSTICS_NAME	Ecronay Austicscay
ITEM_NECRO_CAUSTICS_DESCRIPTION	Ommoncay othingclay ornway byyay Impsyay.
ITEM_NOBLE_PANTS_NAME	Oblenay Antspay
ITEM_NOBLE_PANTS_DESCRIPTION	
ITEM_NUTSO_PANTS_NAME	Utsonay Antspay
ITEM_NUTSO_PANTS_DESCRIPTION	Ommoncay othingclay ornway byyay Angschay.
ITEM_SAGECLOTH_SHORTS_NAME	Ageclothsay Ortsshay
ITEM_SAGECLOTH_SHORTS_DESCRIPTION	Ommoncay othingclay ornway byyay Uboldskay.
ITEM_SILKEN_LOINCLOTH_NAME	Ilkensay Oinclothlay
ITEM_SILKEN_LOINCLOTH_DESCRIPTION	Ancientyay oinclothlay.
ITEM_TEST_PANTS_NAME	Esttay Antspay
ITEM_TEST_PANTS_DESCRIPTION	Usedyay otay iewvay exturingtay.
ITEM_VAMPIRIC_LEGGINGS_NAME	Ampiricvay Eggingslay
ITEM_VAMPIRIC_LEGGINGS_DESCRIPTION	
ITEM_SASH_LEGGINGS_NAME	Ashsay Eggingslay
ITEM_SASH_LEGGINGS_DESCRIPTION	Ighttay.
ITEM_WARRIOR_LEGGINGS_NAME	Arriorway Eggingslay
ITEM_WARRIOR_LEGGINGS_DESCRIPTION	
ITEM_LORD_GREAVES_NAME	Ordlay Eavesgray
ITEM_LORD_GREAVES_DESCRIPTION	Ouryay antspay, iresay?
ITEM_REAPSOW_PANTS_NAME	Eapsowray Antspay
ITEM_REAPSOW_PANTS_DESCRIPTION	
ITEM_WITCHLOCK_LOINCLOTH_NAME	Itchlockway Oinclothlay
ITEM_WITCHLOCK_LOINCLOTH_DESCRIPTION	
ITEM_CHAINMAIL_LEGGINGS_NAME	Ainmailchay Eggingslay
ITEM_CHAINMAIL_LEGGINGS_DESCRIPTION	
ITEM_MERCENARY_LEGGINGS_NAME	Ercenarymay Eggingslay
ITEM_MERCENARY_LEGGINGS_DESCRIPTION	
ITEM_DARKCLOTH_PANTS_NAME	Arkclothday Antspay
ITEM_DARKCLOTH_PANTS_DESCRIPTION	
ITEM_STRIDEBOND_PANTS_NAME	Idebondstray Antspay
ITEM_STRIDEBOND_PANTS_DESCRIPTION	
ITEM_KING_GREAVES_NAME	Ingkay Eavesgray
ITEM_KING_GREAVES_DESCRIPTION	Ouryay antspay, myyay iegelay?
ITEM_REAPER_LEGGINGS_NAME	Eaperray Eggingslay
ITEM_REAPER_LEGGINGS_DESCRIPTION	
ITEM_WITCHWIZARD_GARTERBELT_NAME	Itchwizardway Arterbeltgay
ITEM_WITCHWIZARD_GARTERBELT_DESCRIPTION	
ITEM_SLIMECRUST_LEGGINGS_NAME	Imecrustslay Eggingslay
ITEM_SLIMECRUST_LEGGINGS_DESCRIPTION	Encheddray inyay imeslay.
ITEM_BERSERKER_LEGGINGS_NAME	Erserkerbay Eggingslay
ITEM_BERSERKER_LEGGINGS_DESCRIPTION	
ITEM_FUGUEFALL_PANTS_NAME	Uguefallfay Antspay
ITEM_FUGUEFALL_PANTS_DESCRIPTION	
ITEM_MAGILORD_BOOTS_NAME	Agilordmay Ootsbay
ITEM_MAGILORD_BOOTS_DESCRIPTION	Eepskay ethay oestay armway.
ITEM_GHOSTLY_LEGWRAPS_NAME	Ostlyghay Egwrapslay
ITEM_GHOSTLY_LEGWRAPS_DESCRIPTION	Earingway esethay akemay ouryay egslay eelfay umbnay.
ITEM_JOURNEYMAN_SHORTS_NAME	Ourneymanjay Ortsshay
ITEM_JOURNEYMAN_SHORTS_DESCRIPTION	
ITEM_SLIMEK_LEGGINGS_NAME	Imekslay Eggingslay
ITEM_SLIMEK_LEGGINGS_DESCRIPTION	Encheddray inyay Imekslay imeslay.
ITEM_JOURNEYMAN_LEGGINGS_NAME	Ourneymanjay Eggingslay
ITEM_JOURNEYMAN_LEGGINGS_DESCRIPTION	
ITEM_WOODEN_SHIELD_NAME	Oodenway Ieldshay
ITEM_WOODEN_SHIELD_DESCRIPTION	
ITEM_IRIS_SHIELD_NAME	Irisyay Ieldshay
ITEM_IRIS_SHIELD_DESCRIPTION	Invokeryay ofyay arcaneyay earstay.
ITEM_OMEN_SHIELD_NAME	Omenyay Ieldshay
ITEM_OMEN_SHIELD_DESCRIPTION	Omething'ssay intimidatingyay aboutyay ethay esignday.
ITEM_NETHERCRYPT_SHIELD_NAME	Ethercryptnay Ieldshay
ITEM_NETHERCRYPT_SHIELD_DESCRIPTION	Emblemyay ofyay ethay istedtway ethernay ealmray.
ITEM_MITHRIL_SHIELD_NAME	Ithrilmay Ieldshay
ITEM_MITHRIL_SHIELD_DESCRIPTION	
ITEM_RUSTWEARY_SHIELD_NAME	Ustwearyray Ieldshay
ITEM_RUSTWEARY_SHIELD_DESCRIPTION	Ethay acefay isyay orriedway.
ITEM_RUSTWISE_SHIELD_NAME	Ustwiseray Ieldshay
ITEM_RUSTWISE_SHIELD_DESCRIPTION	Ethay acefay isyay onfidentcay.
ITEM_CRYPT_BUCKLER_NAME	Cryptyay Ucklerbay
ITEM_CRYPT_BUCKLER_DESCRIPTION	Usedyay byyay ancientyay arriorsway ofyay ethay astpay.
ITEM_DEMICRYPT_BUCKLER_NAME	Emicryptday Ucklerbay
ITEM_DEMICRYPT_BUCKLER_DESCRIPTION	Anyay emblemyay ofyay anyay ancientyay arcophogussay.
ITEM_IRON_SHIELD_NAME	Ironyay Ieldshay
ITEM_IRON_SHIELD_DESCRIPTION	
ITEM_OLD_RING_NAME	Oldyay Ingray
ITEM_OLD_RING_DESCRIPTION	
ITEM_RING_OF_AMBITION_NAME	Ingray Ofyay Ambitionyay
ITEM_RING_OF_AMBITION_DESCRIPTION	Omethingsay ikesstray ouyay aboutyay isthay ingray.
ITEM_TEST_RING_NAME	Esttay Ingray
ITEM_TEST_RING_DESCRIPTION	Ityay asway onceyay ossiblepay otay etgay isthay. Ifyay ouyay avehay ityay, ouyay ust'vemay eenbay aroundyay orfay ayay ilewhay...
ITEM_GEISTLORD_RING_NAME	Eistlordgay Ingray
ITEM_GEISTLORD_RING_DESCRIPTION	Isperswhay ofyay Uulneruda'szay emoriesmay echoyay andyay everberateray insideyay ouryay oulsay.
ITEM_STUDENTS_RING_NAME	Udentsstay Ingray
ITEM_STUDENTS_RING_DESCRIPTION	Excelsioryay!
ITEM_PEARLPOND_RING_NAME	Earlpondpay Ingray
ITEM_PEARLPOND_RING_DESCRIPTION	Ethay earlspay imechay, ovidingpray ayay eacepay ofyay indmay andyay arityclay.
ITEM_SLITHERWRAITH_RING_NAME	Itherwraithslay Ingray
ITEM_SLITHERWRAITH_RING_DESCRIPTION	Itherslay oughthray andyay astpay ethay oorsday.
ITEM_ORBOS_RING_NAME	Orbosyay Ingray
ITEM_ORBOS_RING_DESCRIPTION	
ITEM_JADETROUT_RING_NAME	Adetroutjay Ingray
ITEM_JADETROUT_RING_DESCRIPTION	Ethay ailtay ofyay ethay ishfay onyay isthay ingray ovesmay apidlyray.
ITEM_VALOR_RING_NAME	Alorvay Ingray
ITEM_VALOR_RING_DESCRIPTION	
ITEM_GEISTLORD_BAND_NAME	Eistlordgay Andbay
ITEM_GEISTLORD_BAND_DESCRIPTION	Isperswhay ofyay Aluuz'skay emoriesmay echoyay andyay everberateray insideyay ouryay oulsay.
ITEM_EARTHWOKEN_RING_NAME	Earthwokenyay Ingray
ITEM_EARTHWOKEN_RING_DESCRIPTION	Ethay emsgay immerglay uchmay ikelay ethay emsgay ofyay ayay Olossuscay.
ITEM_AMBERSQUIRE_RING_NAME	Ambersquireyay Ingray
ITEM_AMBERSQUIRE_RING_DESCRIPTION	Oughtay asyay ailsnay.
ITEM_EMERALDFOCUS_RING_NAME	Emeraldfocusyay Ingray
ITEM_EMERALDFOCUS_RING_DESCRIPTION	Ethay emeraldyay istensglay evenyay omfray afaryay.
ITEM_SAPPHIREWEAVE_RING_NAME	Apphireweavesay Ingray
ITEM_SAPPHIREWEAVE_RING_DESCRIPTION	Oundssay ofyay ethay oceanyay avesway oughthray ouryay earsyay.
ITEM_WOOD_DAGGERS_NAME	Oodway Aggersday
ITEM_WOOD_DAGGERS_DESCRIPTION	
ITEM_RUNIC_KATARS_NAME	Unicray Atarskay
ITEM_RUNIC_KATARS_DESCRIPTION	Orgedfay byyay ayay adisticsay eingbay ofyay orturetay.
ITEM_GEISTLORD_CLAWS_NAME	Eistlordgay Awsclay
ITEM_GEISTLORD_CLAWS_DESCRIPTION	Edsshray oughthray ethay ailingway oulssay.
ITEM_HELLSLUDGE_SHIVS_NAME	Ellsludgehay Ivsshay
ITEM_HELLSLUDGE_SHIVS_DESCRIPTION	Othay, othay, othay otay ethay ouchtay!
ITEM_MITHRIL_KATARS_NAME	Ithrilmay Atarskay
ITEM_MITHRIL_KATARS_DESCRIPTION	
ITEM_SERRATED_KNUCKLES_NAME	Erratedsay Ucklesknay
ITEM_SERRATED_KNUCKLES_DESCRIPTION	
ITEM_FROSTBITE_CLAWS_NAME	Ostbitefray Awsclay
ITEM_FROSTBITE_CLAWS_DESCRIPTION	Oldcay otay ethay ouchtay...
ITEM_GOLEMFIST_KATARS_NAME	Olemfistgay Atarskay
ITEM_GOLEMFIST_KATARS_DESCRIPTION	Owpay!
ITEM_SLIMECRUST_KATARS_NAME	Imecrustslay Atarskay
ITEM_SLIMECRUST_KATARS_DESCRIPTION	Ironyay Atarskay atthay avehay eenbay ulledday byyay imeslay.
ITEM_SLIMEK_SHIVS_NAME	Imekslay Ivsshay
ITEM_SLIMEK_SHIVS_DESCRIPTION	Esethay earsyay ofyay ayay Imekslay eemsay otay ebay usableyay orfay ombatcay...
ITEM_DEATHGEL_SHIVS_NAME	Eathgelday Ivsshay
ITEM_DEATHGEL_SHIVS_DESCRIPTION	Ottedray, eadlyday Eathgelday earsyay.
ITEM_IRON_KATARS_NAME	Ironyay Atarskay
ITEM_IRON_KATARS_DESCRIPTION	
ITEM_WOODEN_BOW_NAME	Oodenway Owbay
ITEM_WOODEN_BOW_DESCRIPTION	
ITEM_MENACE_BOW_NAME	Enacemay Owbay
ITEM_MENACE_BOW_DESCRIPTION	Ouyay eelfay ayay urgesay ofyay iftnesssway oldinghay isthay owbay.
ITEM_PETRIFIED_BOW_NAME	Etrifiedpay Owbay
ITEM_PETRIFIED_BOW_DESCRIPTION	Ostlay oulssay ofyay ethay amnedday areyay eldedway otay isthay owbay.
ITEM_NECROROYAL_BOW_NAME	Ecroroyalnay Owbay
ITEM_NECROROYAL_BOW_DESCRIPTION	
ITEM_MITHRIL_BOW_NAME	Ithrilmay Owbay
ITEM_MITHRIL_BOW_DESCRIPTION	
ITEM_SERRATED_LONGBOW_NAME	Erratedsay Ongbowlay
ITEM_SERRATED_LONGBOW_DESCRIPTION	Arpshay andyay istedtway. Iresfay arrowsyay atthay iercepay.
ITEM_COLDGEIST_BOW_NAME	Oldgeistcay Owbay
ITEM_COLDGEIST_BOW_DESCRIPTION	Uinationray ofyay ethay ostlay ozenfray oulssay.
ITEM_CRYPT_BOW_NAME	Cryptyay Owbay
ITEM_CRYPT_BOW_DESCRIPTION	Ue-likeglay ootsay eepskay ethay onesbay ogethertay.
ITEM_DEMICRYPT_BOW_NAME	Emicryptday Owbay
ITEM_DEMICRYPT_BOW_DESCRIPTION	Ethay onesbay oldinghay isthay owbay ogethertay eemsay eshfray.
ITEM_IRON_BOW_NAME	Ironyay Owbay
ITEM_IRON_BOW_DESCRIPTION	
ITEM_MEKSPIKE_BOW_NAME	Ekspikemay Owbay
ITEM_MEKSPIKE_BOW_DESCRIPTION	Ethay onstructcay ofyay isthay owbay isyay imilarsay ofyay ayay Ekboarmay.
ITEM_WOOD_SWORD_NAME	Oodway Ordsway
ITEM_WOOD_SWORD_DESCRIPTION	
ITEM_DAWN_MACE_NAME	Awnday Acemay
ITEM_DAWN_MACE_DESCRIPTION	Ubbedclay otay eathday.
ITEM_RUDE_BLADE_NAME	Uderay Adeblay
ITEM_RUDE_BLADE_DESCRIPTION	On'tday ouyay avehay anythingyay etterbay otay illkay?
ITEM_VILE_BLADE_NAME	Ilevay Adeblay
ITEM_VILE_BLADE_DESCRIPTION	Ayay Uderay Adeblay, utbay oremay... ilevay.
ITEM_NETHERCRYPT_BLADE_NAME	Ethercryptnay Adeblay
ITEM_NETHERCRYPT_BLADE_DESCRIPTION	Istedtway, infusedyay ithway ethernay agicmay.
ITEM_MITHRIL_SWORD_NAME	Ithrilmay Ordsway
ITEM_MITHRIL_SWORD_DESCRIPTION	
ITEM_SERRATED_BLADE_NAME	Erratedsay Adeblay
ITEM_SERRATED_BLADE_DESCRIPTION	
ITEM_COLDGEIST_BLADE_NAME	Oldgeistcay Adeblay
ITEM_COLDGEIST_BLADE_DESCRIPTION	Orgedfay omfray orruptedcay ostfray, ormallyfay usedyay byyay ancientyay agessay.
ITEM_SLIMECRUST_BLADE_NAME	Imecrustslay Adeblay
ITEM_SLIMECRUST_BLADE_DESCRIPTION	Ookslay otay ebay anyay Ironyay Ordsway, utbay ethay adeblay isyay intenselyyay ulledday byyay imeslay.
ITEM_CRYPT_BLADE_NAME	Cryptyay Adeblay
ITEM_CRYPT_BLADE_DESCRIPTION	Ethay arpedshay adeblay asway ayay onebay ofyay ayay admanmay.
ITEM_GILDED_SWORD_NAME	Ildedgay Ordsway
ITEM_GILDED_SWORD_DESCRIPTION	Ookslay otay avehay ayay ornway outyay adeblay, utbay illstay arpshay enoughyay orfay ityay otay oday omesay amageday.
ITEM_IRON_SWORD_NAME	Ironyay Ordsway
ITEM_IRON_SWORD_DESCRIPTION	
ITEM_DEMICRYPT_BLADE_NAME	Emicryptday Adeblay
ITEM_DEMICRYPT_BLADE_DESCRIPTION	Isperswhay ofyay ethay eadday areyay ealedsay inyay isthay ordsway.
ITEM_WOOD_HAMMER_NAME	Oodway Ammerhay
ITEM_WOOD_HAMMER_DESCRIPTION	
ITEM_CRYPT_POUNDER_NAME	Cryptyay Ounderpay
ITEM_CRYPT_POUNDER_DESCRIPTION	Ademay ithway ethay onesbay ofyay innerssay.
ITEM_STONE_GREATBLADE_NAME	Onestay Eatbladegray
ITEM_STONE_GREATBLADE_DESCRIPTION	
ITEM_POLTERGEIST_SCYTHE_NAME	Oltergeistpay Escythay
ITEM_POLTERGEIST_SCYTHE_DESCRIPTION	Ethay ighesthay iertay ofyay ayay Eist'sgay escythay.
ITEM_MITHRIL_GREATSWORD_NAME	Ithrilmay Eatswordgray
ITEM_MITHRIL_GREATSWORD_DESCRIPTION	
ITEM_DEADWOOD_AXE_NAME	Eadwoodday Axeyay
ITEM_DEADWOOD_AXE_DESCRIPTION	Isthay asway edgedway eepday intoyay ayay Eadwoodday. Originsyay ofyay ethay ausecay isyay ayay erymystay.
ITEM_COLDGEIST_PUNISHER_NAME	Oldgeistcay Unisherpay
ITEM_COLDGEIST_PUNISHER_DESCRIPTION	Ethay adeblay ofyay ethay axeyay isyay oreverfay igidfray.
ITEM_QUAKE_PUMMELER_NAME	Uakeqay Ummelerpay
ITEM_QUAKE_PUMMELER_DESCRIPTION	Ashsmay emthay allyay intoyay oblivionyay.
ITEM_MINI_GEIST_SCYTHE_NAME	Inimay Eistgay Escythay
ITEM_MINI_GEIST_SCYTHE_DESCRIPTION	Ethay onlyyay estbay iendfray ofyay ayay Inimay Eistgay. Ethay adeblay emanatesyay enacinglymay.
ITEM_SLIMEK_AXEHAMMER_NAME	Imekslay Axehammeryay
ITEM_SLIMEK_AXEHAMMER_DESCRIPTION	Anyay Ironyay Axehammeryay at'sthay eensay etterbay aysday. It'syay ayay ittlelay itbay ofyay ayay allengechay otay aintainmay ayay ipgray onyay isthay ingthay.
ITEM_IRON_AXEHAMMER_NAME	Ironyay Axehammeryay
ITEM_IRON_AXEHAMMER_DESCRIPTION	
ITEM_GEIST_SCYTHE_NAME	Eistgay Escythay
ITEM_GEIST_SCYTHE_DESCRIPTION	Ethay oulssay ofyay ethay amnedday esonateray ithinway ethay adeblay.
ITEM_MEKSPEAR_NAME	Ekspearmay
ITEM_MEKSPEAR_DESCRIPTION	Ayay usableyay artisanpay ithway ayay Ekboar'smay earspay attachedyay otay ityay.
ITEM_SINNER_BARDICHE_NAME	Innersay Ardichebay
ITEM_SINNER_BARDICHE_DESCRIPTION	Oodblay ofyay ethay innerssay oatcay isthay eaponway.
ITEM_NECROROYAL_HALBERD_NAME	Ecroroyalnay Alberdhay
ITEM_NECROROYAL_HALBERD_DESCRIPTION	Usedyay byyay ethay oyalray uardgay ofyay ethay undeadyay.
ITEM_MITHRIL_HALBERD_NAME	Ithrilmay Alberdhay
ITEM_MITHRIL_HALBERD_DESCRIPTION	
ITEM_RAGESPEAR_NAME	Agespearray
ITEM_RAGESPEAR_DESCRIPTION	Ethay iptay ofyay ethay earspay ookslay oodyblay, utbay ityay appearsyay otay ebay ayay orrosivecay aterialmay.
ITEM_SERRATED_SPEAR_NAME	Erratedsay Earspay
ITEM_SERRATED_SPEAR_DESCRIPTION	
ITEM_WOOD_SPEAR_NAME	Oodway Earspay
ITEM_WOOD_SPEAR_DESCRIPTION	
ITEM_IRON_SPEAR_NAME	Ironyay Earspay
ITEM_IRON_SPEAR_DESCRIPTION	
ITEM_CRYPTSINGE_HALBERD_NAME	Ingecryptsay Alberdhay
ITEM_CRYPTSINGE_HALBERD_DESCRIPTION	Okepay andyay odpray ethay undeadyay intoyay ubmissionsay.
ITEM_WOOD_SCEPTER_NAME	Oodway Epterscay
ITEM_WOOD_SCEPTER_DESCRIPTION	
ITEM_CRYO_CANE_NAME	Ocryay Anecay
ITEM_CRYO_CANE_DESCRIPTION	Etlay emthay eezefray.
ITEM_SLIME_DIVA_BATON_NAME	Imeslay Ivaday Atonbay
ITEM_SLIME_DIVA_BATON_DESCRIPTION	Onlyyay ayay Imeslay Ivaday ancay ulytray aximizemay ethay ullfay otentialpay ofyay isthay Epterscay.
ITEM_PYRE_CANE_NAME	Epyray Anecay
ITEM_PYRE_CANE_DESCRIPTION	Etlay emthay urnbay.
ITEM_WIZWAND_NAME	Izwandway
ITEM_WIZWAND_DESCRIPTION	Electrifyingyay.
ITEM_NETHERCRYPT_BAUBLE_NAME	Ethercryptnay Aublebay
ITEM_NETHERCRYPT_BAUBLE_DESCRIPTION	It'syay ardhay otay omprehendcay owhay erribletay ethay alformedmay ullskay isyay.
ITEM_MITHRIL_SCEPTER_NAME	Ithrilmay Epterscay
ITEM_MITHRIL_SCEPTER_DESCRIPTION	
ITEM_AQUAPETAL_STAFF_NAME	Aquapetalyay Affstay
ITEM_AQUAPETAL_STAFF_DESCRIPTION	
ITEM_FLAMEPETAL_STAFF_NAME	Amepetalflay Affstay
ITEM_FLAMEPETAL_STAFF_DESCRIPTION	
ITEM_SPLITBARK_SCEPTER_NAME	Itbarksplay Epterscay
ITEM_SPLITBARK_SCEPTER_DESCRIPTION	Armthway eminatesyay omfray ethay ightbray itewhay emsgay.
ITEM_MARROW_BAUBLE_NAME	Arrowmay Aublebay
ITEM_MARROW_BAUBLE_DESCRIPTION	O'swhay ullskay isyay isthay?
ITEM_IRON_SCEPTER_NAME	Ironyay Epterscay
ITEM_IRON_SCEPTER_DESCRIPTION	
ITEM_DEMICRYPT_BAUBLE_NAME	Emicryptday Aublebay
ITEM_DEMICRYPT_BAUBLE_DESCRIPTION	Ethay ullskay oesn'tday eemsay ealray.
ITEM_CRYPTCALL_BELL_NAME	Allcryptcay Ellbay
ITEM_CRYPTCALL_BELL_DESCRIPTION	Ethay ellbay ollstay orfay ethay eadday.
ITEM_MITHRIL_BELL_NAME	Ithrilmay Ellbay
ITEM_MITHRIL_BELL_DESCRIPTION	
ITEM_COLDGEIST_FROSTCALLER_NAME	Oldgeistcay Ostcallerfray
ITEM_COLDGEIST_FROSTCALLER_DESCRIPTION	Usedyay otay awakenyay Eistlordsgay ithway itsyay inespay illingchay onetay.
ITEM_COLOSSUS_TONE_NAME	Olossuscay Onetay
ITEM_COLOSSUS_TONE_DESCRIPTION	Iecespay ofyay ayay Olossuscay areyay embeddedyay intoyay isthay ellbay.
ITEM_WOODEN_BELL_NAME	Oodenway Ellbay
ITEM_WOODEN_BELL_DESCRIPTION	Ethay eaponway isyay ademay ofyay oodway, utbay ityay imeschay asyay ifyay it'syay etalmay.
ITEM_IRON_BELL_NAME	Ironyay Ellbay
ITEM_IRON_BELL_DESCRIPTION	
ITEM_TOME_OF_THE_BANDIT_NAME	Ometay ofyay ethay Anditbay
ITEM_TOME_OF_THE_BANDIT_DESCRIPTION	<color=lime>Ancay onlyyay ebay usedyay inyay ayay Afesay Onezay.</color>\n \nEadingray isthay ometay eachestay ouyay otay ebay ethay <color=lime>imblenay Anditbay assclay.</color> Additionallyyay esetsray andyay eimbursesray ouryay Illskay Ointspay. Otnay eversibleray. 
ITEM_TOME_OF_THE_FIGHTER_NAME	Ometay ofyay ethay Ighterfay
ITEM_TOME_OF_THE_FIGHTER_DESCRIPTION	<color=lime>Ancay onlyyay ebay usedyay inyay ayay Afesay Onezay.</color>\n \nEadingray isthay ometay eachestay ouyay otay ebay ethay <color=red>iercefay Ighterfay assclay.</color> Additionallyyay esetsray andyay eimbursesray ouryay Illskay Ointspay. Otnay eversibleray.
ITEM_TOME_OF_THE_MYSTIC_NAME	Ometay ofyay ethay Icmystay
ITEM_TOME_OF_THE_MYSTIC_DESCRIPTION	<color=lime>Ancay onlyyay ebay usedyay inyay ayay Afesay Onezay.</color>\n \nEadingray isthay ometay eachestay ouyay otay ebay ethay <color=cyan>iseway Icmystay assclay.</color> Additionallyyay esetsray andyay eimbursesray ouryay Illskay Ointspay. Otnay eversibleray.
ITEM_BLUE_DYE_NAME	Ueblay Edyay
ITEM_BLUE_DYE_DESCRIPTION	Ayay ialvay ofyay ueblay edyay. Useyay ityay otay akemay ouryay eargay edyay olorcay ueblay.
ITEM_GREEN_DYE_NAME	Eengray Edyay
ITEM_GREEN_DYE_DESCRIPTION	Ayay ialvay ofyay eengray edyay. Useyay ityay otay akemay ouryay eargay edyay olorcay eengray.
ITEM_GREY_DYE_NAME	Eygray Edyay
ITEM_GREY_DYE_DESCRIPTION	Ayay ialvay ofyay eygray edyay. Useyay ityay otay akemay ouryay eargay edyay olorcay eygray.
ITEM_RED_DYE_NAME	Edray Edyay
ITEM_RED_DYE_DESCRIPTION	Ayay ialvay ofyay edray edyay. Useyay ityay otay akemay ouryay eargay edyay olorcay edray.
ITEM_SKILL_SCROLL_ALACRITY_NAME	Illskay Ollscray (Alacrityyay)
ITEM_SKILL_SCROLL_ALACRITY_DESCRIPTION	Eachestay ethay useryay Alacrityyay.
ITEM_SKILL_SCROLL_CRYO_NEEDLE_NAME	Illskay Ollscray (Ocryay Eedlenay)
ITEM_SKILL_SCROLL_CRYO_NEEDLE_DESCRIPTION	Eachestay ethay useryay Ocryay Eedlenay.
ITEM_SKILL_SCROLL_EXECUTE_NAME	Illskay Ollscray (Executeyay)
ITEM_SKILL_SCROLL_EXECUTE_DESCRIPTION	Eachestay ethay useryay Executeyay.
ITEM_SKILL_SCROLL_FIREBALL_NAME	Illskay Ollscray (Ireballfay)
ITEM_SKILL_SCROLL_FIREBALL_DESCRIPTION	Eachestay ethay useryay Ireballfay.
ITEM_SKILL_SCROLL_INNER_FOCUS_NAME	Illskay Ollscray (Inneryay Ocusfay)
ITEM_SKILL_SCROLL_INNER_FOCUS_DESCRIPTION	Eachestay ethay useryay Inneryay Ocusfay.
ITEM_SKILL_SCROLL_LEG_UP_NAME	Illskay Ollscray (Eglay Upyay)
ITEM_SKILL_SCROLL_LEG_UP_DESCRIPTION	Eachestay ethay useryay Eglay Upyay.
ITEM_SKILL_SCROLL_SIPHON_LEECH_NAME	Illskay Ollscray (Iphonsay Eechlay)
ITEM_SKILL_SCROLL_SIPHON_LEECH_DESCRIPTION	Eachestay ethay useryay Iphonsay Eechlay.
ITEM_SKILL_SCROLL_SPIRE_NAME	Illskay Ollscray (Irespay)
ITEM_SKILL_SCROLL_SPIRE_DESCRIPTION	Eachestay ethay useryay Irespay.
ITEM_SKILL_SCROLL_SPREAD_SHOT_NAME	Illskay Ollscray (Eadspray Otshay)
ITEM_SKILL_SCROLL_SPREAD_SHOT_DESCRIPTION	Eachestay ethay useryay Eadspray Otshay.
ITEM_SKILL_SCROLL_STURDY_NAME	Illskay Ollscray (Urdystay)
ITEM_SKILL_SCROLL_STURDY_DESCRIPTION	Eachestay ethay useryay Urdystay.
ITEM_SKILL_SCROLL_BELL_MASTERY_NAME	Illskay Ollscray (Ellbay Asterymay)
ITEM_SKILL_SCROLL_BELL_MASTERY_DESCRIPTION	Eachestay ethay useryay Ellbay Asterymay.
ITEM_SKILL_SCROLL_HEAVY_MELEE_MASTERY_NAME	Illskay Ollscray (Eavyhay Eleemay Asterymay)
ITEM_SKILL_SCROLL_HEAVY_MELEE_MASTERY_DESCRIPTION	Eachestay ethay useryay Eavyhay Eleemay Asterymay.
ITEM_SKILL_SCROLL_KATAR_MASTERY_NAME	Illskay Ollscray (Atarkay Asterymay)
ITEM_SKILL_SCROLL_KATAR_MASTERY_DESCRIPTION	Eachestay ethay useryay Atarkay Asterymay.
ITEM_SKILL_SCROLL_MELEE_MASTERY_NAME	Illskay Ollscray (Eleemay Asterymay)
ITEM_SKILL_SCROLL_MELEE_MASTERY_DESCRIPTION	Eachestay ethay useryay Eleemay Asterymay.
ITEM_SKILL_SCROLL_POLEARM_MASTERY_NAME	Illskay Ollscray (Olearmpay Asterymay)
ITEM_SKILL_SCROLL_POLEARM_MASTERY_DESCRIPTION	Eachestay ethay useryay Olearmpay Asterymay.
ITEM_SKILL_SCROLL_RANGED_MASTERY_NAME	Illskay Ollscray (Angedray Asterymay)
ITEM_SKILL_SCROLL_RANGED_MASTERY_DESCRIPTION	Eachestay ethay useryay Angedray Asterymay.
ITEM_SKILL_SCROLL_SCEPTER_MASTERY_NAME	Illskay Ollscray (Epterscay Asterymay)
ITEM_SKILL_SCROLL_SCEPTER_MASTERY_DESCRIPTION	Eachestay ethay useryay Epterscay Asterymay.
ITEM_SKILL_SCROLL_DIVINE_NAME	Illskay Ollscray (Ivineday)
ITEM_SKILL_SCROLL_DIVINE_DESCRIPTION	Eachestay ethay useryay Ivineday.
ITEM_SKILL_SCROLL_LIFE_TAP_NAME	Illskay Ollscray (Ifelay Aptay)
ITEM_SKILL_SCROLL_LIFE_TAP_DESCRIPTION	Eachestay ethay useryay Ifelay Aptay.
ITEM_BUNBAG_NAME	Unbagbay
ITEM_BUNBAG_DESCRIPTION	Ayay atuitousgray ealinghay alvesay.
ITEM_BUNJAR_NAME	Unjarbay
ITEM_BUNJAR_DESCRIPTION	Ayay igbay ealinghay alvesay.
ITEM_BUNPOT_NAME	Unpotbay
ITEM_BUNPOT_DESCRIPTION	Ayay allsmay ealinghay alvesay.
ITEM_CARROT_CAKE_NAME	Arrotcay Akecay
ITEM_CARROT_CAKE_DESCRIPTION	Ayay eliciousday eattray amongstyay Anctumsay.
ITEM_MAGICLOVE_NAME	Agiclovemay
ITEM_MAGICLOVE_DESCRIPTION	Ayay argelay indmay eplenishingray oveclay.
ITEM_MAGIFLOWER_NAME	Agiflowermay
ITEM_MAGIFLOWER_DESCRIPTION	Ayay atuitousgray indmay eplenishingray owerflay.
ITEM_MAGILEAF_NAME	Agileafmay
ITEM_MAGILEAF_DESCRIPTION	Ayay allsmay indmay eplenishingray eaflay.
ITEM_SPECTRAL_POWDER_NAME	Ectralspay Owderpay
ITEM_SPECTRAL_POWDER_DESCRIPTION	Otentpay ixturemay ofyay oundedgray ostlyghay ubstancesay. Anishesvay ethay useryay orfay ayay ortshay urationday.
ITEM_STAMSTAR_NAME	Amstarstay
ITEM_STAMSTAR_DESCRIPTION	Enchingclay isthay arstay ivesgay ayay uddensay oostbay ofyay energyyay.
ITEM_MINCHROOM_JUICE_NAME	Inchroommay Uicejay
ITEM_MINCHROOM_JUICE_DESCRIPTION	Astytay Inchroommay oodblay.
ITEM_LESSER_DEFENSE_POTION_NAME	Esserlay Efenseday Otionpay
ITEM_LESSER_DEFENSE_POTION_DESCRIPTION	Emporarilytay increasesyay Efenseday byyay 5.
ITEM_LESSER_EVASION_POTION_NAME	Esserlay Evasionyay Otionpay
ITEM_LESSER_EVASION_POTION_DESCRIPTION	Emporarilytay increasesyay Evasionyay byyay 3%.
ITEM_LESSER_MGK_DEFENSE_POTION_NAME	Esserlay Mgkyay. Efenseday Otionpay
ITEM_LESSER_MGK_DEFENSE_POTION_DESCRIPTION	Emporarilytay increasesyay Agicmay Efenseday byyay 5.
ITEM_LESSER_REGENERATION_POTION_NAME	Esserlay Egenerationray Otionpay
ITEM_LESSER_REGENERATION_POTION_DESCRIPTION	Emporarilytay egeneratesray 3 ealthhay overyay imetay.
ITEM_DEFENSE_POTION_NAME	Efenseday Otionpay
ITEM_DEFENSE_POTION_DESCRIPTION	Emporarilytay increasesyay Efenseday byyay 10.
ITEM_EVASION_POTION_NAME	Evasionyay Otionpay
ITEM_EVASION_POTION_DESCRIPTION	Emporarilytay increasesyay Evasionyay byyay 5%.
ITEM_MGK_DEFENSE_POTION_NAME	Mgkyay. Efenseday Otionpay
ITEM_MGK_DEFENSE_POTION_DESCRIPTION	Emporarilytay increasesyay Agicmay Efenseday byyay 10.
ITEM_REGENERATION_POTION_NAME	Egenerationray Otionpay
ITEM_REGENERATION_POTION_DESCRIPTION	Emporarilytay egeneratesray 8 ealthhay overyay imetay.
ITEM_TOME_OF_EXPERIENCE_NAME	Ometay ofyay Experienceyay
ITEM_TOME_OF_EXPERIENCE_DESCRIPTION	Ethay owledgeknay isthay Ometay ovidespray ivesgay ayay izablesay ilepay ofyay experienceyay otay ethay eaderray.
ITEM_TOME_OF_GREATER_EXPERIENCE_NAME	Ometay ofyay Eatergray Experienceyay
ITEM_TOME_OF_GREATER_EXPERIENCE_DESCRIPTION	Ethay owledgeknay isthay Ometay ovidespray ivesgay ayay assivemay ilepay ofyay experienceyay otay ethay eaderray.
ITEM_TOME_OF_LESSER_EXPERIENCE_NAME	Ometay ofyay Esserlay Experienceyay
ITEM_TOME_OF_LESSER_EXPERIENCE_DESCRIPTION	Ethay owledgeknay isthay Ometay ovidespray ivesgay ayay andfulhay ofyay experienceyay otay ethay eaderray.
ITEM_TOME_OF_NAIVETY_NAME	Ometay ofyay Aivetynay
ITEM_TOME_OF_NAIVETY_DESCRIPTION	Eadingray isthay ometay esetsray allyay ofyay ouryay Attributesyay, eimbursingray ouryay Attributeyay Ointspay. <color=lime>Ancay onlyyay ebay usedyay inyay ayay Afesay Onezay.</color>
ITEM_TOME_OF_UNLEARNING_NAME	Ometay ofyay Unlearningyay
ITEM_TOME_OF_UNLEARNING_DESCRIPTION	Eadingray isthay ometay unlearnsyay allyay ouryay Illsskay, eimbursingray allyay ouryay entspay Illskay Ointspay. <color=lime>Ancay onlyyay ebay usedyay inyay ayay Afesay Onezay.</color>
ITEM_AGILITY_STONE_NAME	Agilityyay Onestay
ITEM_AGILITY_STONE_DESCRIPTION	Ashay apabilitiescay otay angechay ayay eaponway amageday alescay otay exterityday.
ITEM_ANGELAS_TEAR_NAME	Angela'syay Eartay
ITEM_ANGELAS_TEAR_DESCRIPTION	Instantlyyay evivesray ethay olderhay ifyay eythay ieday.
ITEM_BLIGHTWOOD_LOG_NAME	Ightwoodblay Oglay
ITEM_BLIGHTWOOD_LOG_DESCRIPTION	Ethay insideyay isyay eryvay othay, ontainingcay ayay urningbay ueblay ameflay atthay evernay eemssay otay ogay outyay.
ITEM_BLIGHTWOOD_STICK_NAME	Ightwoodblay Ickstay
ITEM_BLIGHTWOOD_STICK_DESCRIPTION	Eelsfay armway otay oldhay.
ITEM_BLUE_MINCHROOM_CAP_NAME	Ueblay Inchroommay Apcay
ITEM_BLUE_MINCHROOM_CAP_DESCRIPTION	Ethay oresspay ancay ostbitefray omethingsay. Ouldcay ebay oodgay otay eepkay ayay oomray oolcay.
ITEM_BRONZE_ARROWS_NAME	Onzebray Arrowsyay
ITEM_BRONZE_ARROWS_DESCRIPTION	Ammunitionyay orfay owsbay.
ITEM_CARBUNCLE_FOOT_NAME	Arbunclecay Ootfay
ITEM_CARBUNCLE_FOOT_DESCRIPTION	Ethay ootfay ofyay ayay orruptedcay agesay. Ethay oodblay atthay ipsdray omfray ityay uicklyqay ecomesbay ayay agicalmay owderpay.
ITEM_CURSED_NOTE_NAME	Ursedcay Otenay
ITEM_CURSED_NOTE_DESCRIPTION	Erethay areyay agicmay glyphsyay onyay isthay otenay. Eythay eemsay otay owlyslay oatflay aboveyay ethay archmentpay.
ITEM_DEADWOOD_LOG_NAME	Eadwoodday Oglay
ITEM_DEADWOOD_LOG_DESCRIPTION	Othay orangeyay energyyay eminatesyay ithinway isthay oglay.
ITEM_DEATHGEL_CORE_NAME	Eathgelday Orecay
ITEM_DEATHGEL_CORE_DESCRIPTION	Ayay unkchay ofyay ayay Eathgelday.
ITEM_DIVA_NECKLACE_NAME	Ivaday Ecklacenay
ITEM_DIVA_NECKLACE_DESCRIPTION	Ootay igbay otay earway, oughthay uiteqay aluablevay.
ITEM_FLUX_STONE_NAME	Uxflay Onestay
ITEM_FLUX_STONE_DESCRIPTION	Ashay apabilitiescay otay angechay ayay eaponway amageday alescay otay indmay.
ITEM_GEIST_COLLAR_NAME	Eistgay Ollarcay
ITEM_GEIST_COLLAR_DESCRIPTION	Akingshay ethay ellbay oesn'tday akemay anyyay oisenay.
ITEM_GHOSTDUST_NAME	Ostdustghay
ITEM_GHOSTDUST_DESCRIPTION	Ottledbay ectralspay ashesyay ofyay ayay estlessray ostghay.
ITEM_GOLEM_CORE_NAME	Olemgay Orecay
ITEM_GOLEM_CORE_DESCRIPTION	Ethay onceyay unctioningfay earthay ofyay ayay Olemgay. Uiteqay eavyhay.
ITEM_GOLEM_GEM_NAME	Olemgay Emgay
ITEM_GOLEM_GEM_DESCRIPTION	Ayay edray istmay iststway andyay urnstay ithinway isthay emgay.
ITEM_GREEN_LIPSTICK_NAME	Eengray Ipsticklay
ITEM_GREEN_LIPSTICK_DESCRIPTION	Astestay ikelay oursay appleyay andycay.
ITEM_HELLSLUDGE_CORE_NAME	Ellsludgehay Orecay
ITEM_HELLSLUDGE_CORE_DESCRIPTION	Ayay unkchay ofyay ayay Ellsludgehay.
ITEM_ILLUSION_STONE_NAME	Illusionyay Onestay
ITEM_ILLUSION_STONE_DESCRIPTION	Isthay agicalmay onestay ancay ebay usedyay otay angechay ethay appearanceyay ofyay ingsthay.
ITEM_MAW_EYE_NAME	Awmay Eyeyay
ITEM_MAW_EYE_DESCRIPTION	Ere'sthay ayay areglay ofyay anxietyyay inyay ethay ilatedday upilpay.
ITEM_MEKBOAR_HEAD_NAME	Ekboarmay Eadhay
ITEM_MEKBOAR_HEAD_DESCRIPTION	Ethay outsnay ontinuescay otay ulsepay andyay iggleway aroundyay.
ITEM_MEKBOAR_SPEAR_NAME	Ekboarmay Earspay
ITEM_MEKBOAR_SPEAR_DESCRIPTION	Ityay isyay unknownyay owhay isthay earspay asway attachedyay otay ayay oarbay.
ITEM_MIGHT_STONE_NAME	Ightmay Onestay
ITEM_MIGHT_STONE_DESCRIPTION	Ashay apabilitiescay otay angechay ayay eaponway amageday alescay otay engthstray.
ITEM_MONOLITH_CORE_NAME	Onolithmay Orecay
ITEM_MONOLITH_CORE_DESCRIPTION	Ethay earthay ofyay ayay Onolithmay. Arkday eengray energyyay ulsatespay omfray ithinway ityay.
ITEM_MONOLITH_GEM_NAME	Onolithmay Emgay
ITEM_MONOLITH_GEM_DESCRIPTION	Ayay eftyhay, eengray emgay omfray ayay Onolithmay. Erhapspay ityay isyay utatedmay.
ITEM_MOUTH_BITTERTOOTH_NAME	Outhmay Ittertoothbay
ITEM_MOUTH_BITTERTOOTH_DESCRIPTION	Ethay iptay ofyay ethay oothtay endlesslyyay ipsdray ayay ittlelay itbay ofyay oisonpay.
ITEM_MOUTH_EYE_NAME	Outhmay Eyeyay
ITEM_MOUTH_EYE_DESCRIPTION	Uishysqay. Oughthay, ityay an'tcay ebay oppedpay.
ITEM_RAGEBOAR_HEAD_NAME	Ageboarray Eadhay
ITEM_RAGEBOAR_HEAD_DESCRIPTION	Ethay eyesyay areyay oodshotblay andyay illedfay ithway ageray.
ITEM_RAGEBOAR_SPEAR_NAME	Ageboarray Earspay
ITEM_RAGEBOAR_SPEAR_DESCRIPTION	Ethay oodstainblay onyay isthay earspay eansmay eadlyday usinessbay.
ITEM_RED_MINCHROOM_CAP_NAME	Edray Inchroommay Apcay
ITEM_RED_MINCHROOM_CAP_DESCRIPTION	Ethay oresspay ancay etsay omethingsay onyay irefay. Ouldcay ebay oodgay otay ookcay omethingsay icyspay ithway.
ITEM_ROCK_NAME	Ockray
ITEM_ROCK_DESCRIPTION	Ustjay anyay ordinaryyay ockray. Ouldcay ebay ossedtay atyay enemiesyay.
ITEM_SLIME_CORE_NAME	Imeslay Orecay
ITEM_SLIME_CORE_DESCRIPTION	Ayay unkchay ofyay ayay Imeslay.
ITEM_SLIME_DIVA_EARS_NAME	Imeslay Ivaday Earsyay
ITEM_SLIME_DIVA_EARS_DESCRIPTION	Extremelyyay argelay andyay onglay earsyay. Unlikeyay otheryay imeslay earsyay, esethay areyay otnay arpshay otay ethay ouchtay, utbay atherray oftsay.
ITEM_SLIME_EARS_NAME	Imeslay Earsyay
ITEM_SLIME_EARS_DESCRIPTION	Esethay areyay omehowsay arpshay onyay ethay endsyay, ichwhay ancay actuallyyay urthay.
ITEM_SLIMEK_CORE_NAME	Imekslay Orecay
ITEM_SLIMEK_CORE_DESCRIPTION	Ayay unkchay ofyay ayay Imekslay.
ITEM_SLIMEK_EARS_NAME	Imekslay Earsyay
ITEM_SLIMEK_EARS_DESCRIPTION	Evenyay arpershay anthay ormalnay Imeslay earsyay.
ITEM_SLIMEK_EYE_NAME	Imekslay Eyeyay
ITEM_SLIMEK_EYE_DESCRIPTION	Ethay irlysway upilpay otatesray ifyay ouyay ooklay atyay ityay onglay enoughyay.
ITEM_SOUL_PEARL_NAME	Oulsay Earlpay
ITEM_SOUL_PEARL_DESCRIPTION	Allowsyay ethay olderhay otay eviveray ayay allenfay oulsay.\n eviveray omeonesay, esspray ethay interactyay eykay enwhay earbynay emthay.</color>
ITEM_WIZBOAR_HEAD_NAME	Izboarway Eadhay
ITEM_WIZBOAR_HEAD_DESCRIPTION	It'syay illstay ilingsmay.
ITEM_WIZBOAR_SCEPTER_NAME	Izboarway Epterscay
ITEM_WIZBOAR_SCEPTER_DESCRIPTION	Eemingtay ithway electricityyay. Ootay igbay ofyay ayay eaponway otay useyay onyay ouryay ownyay.
CREEP_LESSER_WISP_NAME	Esserlay Ispway
CREEP_LESSER_WISP_NAME_VARIANT_MANY	Esserlay Ispsway
CREEP_MIASMA_NAME	Iasmamay
CREEP_MIASMA_NAME_VARIANT_MANY	Iasmasmay
CREEP_GREATER_WISP_NAME	Eatergray Ispway
CREEP_GREATER_WISP_NAME_VARIANT_MANY	Eatergray Ispsway
CREEP_TOXIN_NAME	Oxintay
CREEP_TOXIN_NAME_VARIANT_MANY	Oxinstay
CREEP_ALSHAR_NAME	Alsharyay
CREEP_ALSHAR_NAME_VARIANT_MANY	Alsharsyay
CREEP_CARBUNCLE_NAME	Arbunclecay
CREEP_CARBUNCLE_NAME_VARIANT_MANY	Arbunclescay
CREEP_STEZZA_NAME	Ezzastay
CREEP_STEZZA_NAME_VARIANT_MANY	Ezzasstay
CREEP_POLTERGEIST_NAME	Oltergeistpay
CREEP_POLTERGEIST_NAME_VARIANT_MANY	Oltergeistspay
CREEP_MINI_GEIST_NAME	Inimay Eistgay
CREEP_MINI_GEIST_NAME_VARIANT_MANY	Inimay Eistsgay
CREEP_GEIST_NAME	Eistgay
CREEP_GEIST_NAME_VARIANT_MANY	Eistsgay
CREEP_LORD_ZUULNERUDA_NAME	Ordlay Uulnerudazay
CREEP_LORD_ZUULNERUDA_NAME_VARIANT_MANY	Ordlay Uulnerudaszay
CREEP_LORD_KALUUZ_NAME	Ordlay Aluuzkay
CREEP_LORD_KALUUZ_NAME_VARIANT_MANY	Ordlay Aluuzskay
CREEP_GOLEM_NAME	Olemgay
CREEP_GOLEM_NAME_VARIANT_MANY	Olemsgay
CREEP_MONOLITH_NAME	Onolithmay
CREEP_MONOLITH_NAME_VARIANT_MANY	Onolithsmay
CREEP_DEMIGOLEM_NAME	Emigolemday
CREEP_DEMIGOLEM_NAME_VARIANT_MANY	Emigolemsday
CREEP_COLOSSUS_NAME	Olossuscay
CREEP_COLOSSUS_NAME_VARIANT_MANY	Olossusscay
CREEP_BROXXUS_NAME	Oxxusbray
CREEP_BROXXUS_NAME_VARIANT_MANY	Oxxussbray
CREEP_MEKBOAR_NAME	Ekboarmay
CREEP_MEKBOAR_NAME_VARIANT_MANY	Ekboarsmay
CREEP_BOOMBOAR_NAME	Oomboarbay
CREEP_BOOMBOAR_NAME_VARIANT_MANY	Oomboarsbay
CREEP_RAGEBOAR_NAME	Ageboarray
CREEP_RAGEBOAR_NAME_VARIANT_MANY	Ageboarsray
CREEP_WIZBOAR_NAME	Izboarway
CREEP_WIZBOAR_NAME_VARIANT_MANY	Izboarsway
CREEP_BLUE_MINCHROOM_NAME	Ueblay Inchroommay
CREEP_BLUE_MINCHROOM_NAME_VARIANT_MANY	Ueblay Inchroomsmay
CREEP_RED_MINCHROOM_NAME	Edray Inchroommay
CREEP_RED_MINCHROOM_NAME_VARIANT_MANY	Edray Inchroomsmay
CREEP_YELLOW_MINCHROOM_NAME	Ellowyay Inchroommay
CREEP_YELLOW_MINCHROOM_NAME_VARIANT_MANY	Ellowyay Inchroomsmay
CREEP_MINI_GOLEM_NAME	Inimay Olemgay
CREEP_MINI_GOLEM_NAME_VARIANT_MANY	Inimay Olemsgay
CREEP_MOUTH_NAME	Outhmay
CREEP_MOUTH_NAME_VARIANT_MANY	Outhsmay
CREEP_MAW_NAME	Awmay
CREEP_MAW_NAME_VARIANT_MANY	Awsmay
CREEP_SLIME_NAME	Imeslay
CREEP_SLIME_NAME_VARIANT_MANY	Imesslay
CREEP_HELLSLUDGE_NAME	Ellsludgehay
CREEP_HELLSLUDGE_NAME_VARIANT_MANY	Ellsludgeshay
CREEP_TAR_SPAWN_NAME	Artay Awnspay
CREEP_TAR_SPAWN_NAME_VARIANT_MANY	Artay Awnsspay
CREEP_SLIMEK_NAME	Imekslay
CREEP_SLIMEK_NAME_VARIANT_MANY	Imeksslay
CREEP_DEATHGEL_NAME	Eathgelday
CREEP_DEATHGEL_NAME_VARIANT_MANY	Eathgelsday
CREEP_SLIME_DIVA_NAME	Imeslay Ivaday
CREEP_SLIME_DIVA_NAME_VARIANT_MANY	Imeslay Ivasday
CREEP_DEADWOOD_NAME	Eadwoodday
CREEP_DEADWOOD_NAME_VARIANT_MANY	Eadwoodsday
CREEP_BLIGHTWOOD_NAME	Ightwoodblay
CREEP_BLIGHTWOOD_NAME_VARIANT_MANY	Ightwoodsblay
CREEP_NOVICE_TRAINING_DUMMY_NAME	Ovicenay Ainingtray Ummyday
CREEP_NOVICE_TRAINING_DUMMY_NAME_VARIANT_MANY	Ovicenay Ainingtray Ummysday
CREEP_CLASS_TRAINING_DUMMY_NAME	Assclay Ainingtray Ummyday
CREEP_CLASS_TRAINING_DUMMY_NAME_VARIANT_MANY	Assclay Ainingtray Ummysday
QUEST_A_WARM_WELCOME_NAME	Ayay Armway Elcomeway
QUEST_A_WARM_WELCOME_DESCRIPTION	Ahyay... Iyay eesay atthay ou'reyay awakeyay, andyay ouryay oulsay isyay asyay ightbray asyay everyay. Easeplay, oday otnay ebay afraidyay. <color=cyan>Isthay aceplay isyay ouryay omehay, ouryay omehay.</color>\n \nEforebay eway ancay eginbay ouryay ourneyjay, easeplay akemay ourselfyay amiliarfay ithway Anctumsay... <color=cyan>Afteryay allyay, isthay isyay ethay astlay afesay avenhay ofyay isthay okenbray orldway.</color>\n \n<color=yellow>Omecay ackbay otay emay afteryay ouyay avehay eensay ethay Orldway Ortalpay, ethay Arracksbay, ethay Opshay, andyay ethay Atewaygay otay ethay Outeryay Anctumsay.</color> \n \n<i>Ofyay oursecay, aketay ouryay imetay...</i>
QUEST_A_WARM_WELCOME_COMPLETE_RETURN_MESSAGE	Eturnray otay Angelayay inyay Anctumsay.
QUEST_TRIGGER_WORLDPORTALTRIGGER_PREFIX	Orldway Ortalpay
QUEST_TRIGGER_WORLDPORTALTRIGGER_SUFFIX	iscoveredday
QUEST_TRIGGER_SHOPDISCOVERTRIGGER_PREFIX	Opshay
QUEST_TRIGGER_SHOPDISCOVERTRIGGER_SUFFIX	iscoveredday
QUEST_TRIGGER_GATEWAYDISCOVERTRIGGER_PREFIX	Atewaygay
QUEST_TRIGGER_GATEWAYDISCOVERTRIGGER_SUFFIX	iscoveredday
QUEST_TRIGGER_BARRACKSDISCOVERTRIGGER_PREFIX	Arracksbay
QUEST_TRIGGER_BARRACKSDISCOVERTRIGGER_SUFFIX	iscoveredday
QUEST_COMMUNING_CATACOMBS_NAME	Ommuningcay Atacombscay
QUEST_COMMUNING_CATACOMBS_DESCRIPTION	It'syay uiteqay ireday, ouyay eesay... ethay <color=cyan>Atacombscay outsideyay Anctumsay</color> asway ayay aceplay Iyay ouldcay ommunecay myyay icmystay energiesyay ithway otay urveysay ethay undeadyay. Atwhay oesgay onyay erethay ownay ashay eenbay allyay ayay erymystay otay emay...\n \n<color=cyan>Enwhay ethay orldway atteredshay, osay idday myyay agicmay.</color> Ortunatelyfay, Iyay ancay illstay eelfay ethay ostlay agicmay existingyay...\n \n<color=yellow>Indfay ethay aystray Igilsay eepday ithinway ethay Atacombscay andyay etlay ityay ethertay otay ouryay oulsay.</color> Onceyay ouyay oday, eway ancay urtherfay exploreyay atwhay oomslay aheadyay ofyay usyay... Iyay oday earfay orfay ethay orstway.
QUEST_COMMUNING_CATACOMBS_COMPLETE_RETURN_MESSAGE	Eturnray otay Angelayay inyay Anctumsay.
QUEST_TRIGGER_SIGILTRIGGER_PREFIX	Igilsay
QUEST_TRIGGER_SIGILTRIGGER_SUFFIX	attunedyay
QUEST_NIGHT_SPIRITS_NAME	Ightnay Iritsspay
QUEST_NIGHT_SPIRITS_DESCRIPTION	<color=cyan>Uringday ethay ightnay,</color> ethay Ispsway omfray ethay Atacombscay earbynay isturbday ethay Outeryay Anctumsay. Omesay Eatergray Ispsway aymay alsoyay ebay oundfay eeperday ithinway ethay Atacombscay itselfyay...\n \n<color=yellow>Abolishyay 8 Esserlay Ispsway andyay 5 Eatergray Ispsway.</color>\n arefulcay, ecausebay <color=cyan>Ispsway ancay ursecay ouyay...</color>
QUEST_NIGHT_SPIRITS_COMPLETE_RETURN_MESSAGE	Eturnray otay Angelayay inyay Anctumsay.
QUEST_RIDDING_SLIMES_NAME	Iddingray Imesslay
QUEST_RIDDING_SLIMES_DESCRIPTION	Ethay Imesslay areyay uiteqay ethay uisancenay outsideyay Anctumsay... Endingfay emthay offyay ouldway elphay usyay eatlygray.\n \n<color=cyan>Imesslay areyay ommonlycay oundfay uringday ethay aytimeday.</color> <color=yellow>Athergay 5 Imeslay Orescay, 5 Imeslay Earsyay andyay illkay 10 Imesslay.</color> Omecay ackbay afelysay...
QUEST_RIDDING_SLIMES_COMPLETE_RETURN_MESSAGE	Eturnray otay Angelayay inyay Anctumsay.
QUEST_DISCIPLE_OF_MAGIC_NAME	Iscipleday ofyay Agicmay
QUEST_DISCIPLE_OF_MAGIC_DESCRIPTION	Ahyay! Erethay ouyay areyay, ittlelay oneyay. I'veyay oticednay atthay ouryay illskay ashay exceededyay eyondbay erewhay ouyay eganbay... <color=cyan>erhapspay, ouyay aymay ebay interestedyay inyay embracingyay ethay udiesstay ofyay ayay Icmystay?</color>\n \nIfyay ouyay areyay uresay otay ollowfay myyay armthway ofyay isdomway andyay uidancegay, <color=yellow>Iyay illway estowbay ayay ometay atthay illway indbay myyay owerspay otay ouyay...</color> Andyay ofyay oursecay, akemay ouryay oicechay iselyway, <color=yellow>asyay ouyay annotcay evertray ityay.</color>\n \nHmmyay... O-Ohyay, esyay! <color=yellow>Ifyay ouyay appenhay otay oselay ouryay ometay ilewhay undecidedyay, easeplay alktay otay emay againyay otay etrieveray anotheryay.</color> 
QUEST_DISCIPLE_OF_MAGIC_COMPLETE_RETURN_MESSAGE	Eturnray otay Angelayay inyay Anctumsay.
QUEST_TRIGGER_GETMYSTICCLASS_PREFIX	Ometay ofyay ethay Icmystay
QUEST_TRIGGER_GETMYSTICCLASS_SUFFIX	eadray
QUEST_MASTERY_OF_BELLS_NAME	Asterymay ofyay Ellsbay
QUEST_MASTERY_OF_BELLS_DESCRIPTION	Avehay ouyay usedyay Agicmay Ellsbay eforebay, ittlelay oneyay? Eythay areyay uiteqay eriousmystay... ellway, eythay <i>ereway</i> eriousmystay. Ortunatelyfay orfay usyay, <color=cyan>Iyay avehay uncoveredyay ethay ecretssay otay useyay emthay atyay eirthay aximummay owerpay!</color>\n \n \n<color=yellow>Aketay isthay ollscray. Eadingray ityay illway eachtay ouyay otay argechay andyay eleaseray owerfulpay agicmay eyondbay omprehensioncay...</color>\n \n<color=yellow>Ahyay, ightray... inyay anyyay asecay ifyay ouryay indmay angeschay, eturnray otay emay, andyay Iyay ancay ovidepray otay ouyay asyay anymay ollsscray asyay ouyay eednay... Eepkay inyay indmay, ethay illskay ollscray illway anishvay ifyay ouyay opdray ityay.</color>
QUEST_MASTERY_OF_BELLS_COMPLETE_RETURN_MESSAGE	Eturnray otay Angelayay inyay Anctumsay.
QUEST_TRIGGER_USEBELLSCROLL_PREFIX	Ellbay Asterymay Ollscray
QUEST_TRIGGER_USEBELLSCROLL_SUFFIX	eadray
QUEST_MASTERY_OF_SCEPTERS_NAME	Asterymay ofyay Eptersscay
QUEST_MASTERY_OF_SCEPTERS_DESCRIPTION	Afteryay anymay earsyay ofyay intensiveyay udyingstay, <color=cyan>Iyay avehay uncoveredyay ethay ecretssay ofyay utilizingyay Agicmay Eptersscay!</color> Ittlelay oneyay, ouldway ouyay ebay interestedyay inyay earninglay emthay asyay ellway? <color=yellow>Ifyay osay, Iyay ancay ovidepray ouyay isthay illskay ollscray.</color> \n \n \n<color=cyan>Useyay ityay, andyay ouyay illway understandyay owhay otay arpenshay ouryay indmay otay uchsay eaponsway...</color>\n \n<color=yellow>Ohyay esyay, ifyay ouyay angechay ouryay indmay, eturnray otay emay, andyay Iyay ancay ovidepray otay ouyay asyay anymay ollsscray asyay ouyay eednay... Eepkay inyay indmay, ethay illskay ollscray illway anishvay ifyay ouyay opdray ityay.</color>\n
QUEST_MASTERY_OF_SCEPTERS_COMPLETE_RETURN_MESSAGE	Eturnray otay Angelayay inyay Anctumsay.
QUEST_TRIGGER_USESCEPTERSCROLL_PREFIX	Epterscay Asterymay Ollscray
QUEST_TRIGGER_USESCEPTERSCROLL_SUFFIX	eadray
QUEST_THE_KEEP_WITHIN_NAME	Ethay Eepkay Ithinway
QUEST_THE_KEEP_WITHIN_DESCRIPTION	Ethay orldway isyay ealinghay, ittlelay oneyay... Eway ustmay eesay atwhay ieslay utherfay eyondbay andyay esspray onyay. <color=cyan>Ifyay emorymay ervessay, erethay isyay ayay ortalpay inyay ethay Effoldyay Erracetay eadinglay otay anyay Ancientyay Eepkay. Ithinway ethay eastyay andyay estway ingway amberschay, erethay areyay igilssay atthay ustmay ebay attunedyay otay ouryay oulsay.</color> Easeplay ebay eparedpray orfay atwhay aymay elldway erethay...
QUEST_THE_KEEP_WITHIN_COMPLETE_RETURN_MESSAGE	Eturnray otay Angelayay inyay Anctumsay.
QUEST_TRIGGER_SIGILTRIGGER_00_PREFIX	Estway Ingway Igilsay
QUEST_TRIGGER_SIGILTRIGGER_00_SUFFIX	attunedyay
QUEST_TRIGGER_SIGILTRIGGER_01_PREFIX	Eastyay Ingway Igilsay
QUEST_TRIGGER_SIGILTRIGGER_01_SUFFIX	attunedyay
QUEST_ANCIENT_BEINGS_NAME	Ancientyay Eingsbay
QUEST_ANCIENT_BEINGS_DESCRIPTION	It'syay oncerningcay, ittlelay oneyay. <color=cyan>Erethay areyay ovesdray ofyay ancientyay Olemsgay oamingray aroundyay Escentcray Eepkay,</color> andyay eythay areyay uiteqay ostilehay... \n \nEthay Olemsgay ereway onceyay eacefulpay onstructscay atthay endedfay offyay onstersmay, utbay ownay eythay avehay urnedtay otay aidyay emthay insteadyay. <color=cyan>Iyay ancay onlyyay assumeyay atthay ethay atteringshay ofyay ethay orldway ausedcay isthay, andyay ethay emsgay eldhay inyay eirthay eadshay ovedray emthay intoyay adnessmay...</color> Eitheryay ayway, Iyay ustmay udystay isthay attermay. \n \n<color=yellow>Efeatday 15 Olemsgay allsmay andyay argelay, andyay ollectcay 15 ofyay eirthay emsgay.</color> Ayay ewardray orfay ouryay oublestray illway ebay inyay orderyay...
QUEST_ANCIENT_BEINGS_COMPLETE_RETURN_MESSAGE	Eturnray otay Angelayay inyay Anctumsay.
QUEST_CONSUMED_MADNESS_NAME	Onsumedcay Adnessmay
QUEST_CONSUMED_MADNESS_DESCRIPTION	Ethay Anctumsay Atacombscay isn'tyay atwhay ouyay ememberray, ittlelay oneyay... Inyay actfay, <color=cyan>ethay uetray incantationyay ofyay ethay Atacombscay isyay openyay orfay usyay otay eesay, andyay it'syay uiteqay ireday.</color> Iyay understandyay atthay ouyay aymay avehay eenbay oughthray osay uchmay, utbay <i>Iyay owknay</i> atthay ouyay ancay oday isthay!\n \nEthay onlyyay ayway otay eepkay ethay Atacombscay omfray ettinggay orseway, <color=yellow>isyay otay atiatesay ethay adnessmay byyay efeatingday ethay orcesfay ofyay undeadyay inyay it'syay orstway ormfay...</color>\n \nEaseplay eturnray otay emay onceyay ouyay avehay oneday isthay asktay... <color=cyan>Iyay eatlygray urgeyay ouyay otay ingbray ealinghay itemsyay ithway ouyay inyay isthay ourneyjay!</color>
QUEST_CONSUMED_MADNESS_COMPLETE_RETURN_MESSAGE	Eturnray otay Angelayay inyay Anctumsay.
QUEST_TRIGGER_SWEEPFINISHHARD_PREFIX	Atacombscay
QUEST_TRIGGER_SWEEPFINISHHARD_SUFFIX	Earedclay (lvyay12-18)
QUEST_SPIRALING_IN_THE_GROVE_NAME	Iralingspay Inyay Ethay Ovegray
QUEST_SPIRALING_IN_THE_GROVE_DESCRIPTION	<color=cyan>Ethay Escentcray Ovegray isyay eemingtay ithway orruptioncay...</color> Asyay adsay asyay ityay isyay otay eesay owhay it'syay urnedtay isthay ayway, ityay ustmay ebay eldhay ackbay omfray ettinggay orseway. \n \n<color=cyan>Iyay owknay atthay ouyay areyay oremay anthay apablecay otay ovidepray ethay urificationpay otay isthay orruptedcay ovegray, ittlelay oneyay.</color>\n \n<color=yellow>Omfray ethay eginningbay otay ethay endyay ofyay ethay Escentcray Ovegray, ayslay allyay ethay onstersmay atthay elldway ithinway ityay.</color> Asyay ouyay owknay, eythay esideray inyay ethay azyhay arkday agicmay, andyay onlyyay appearyay enwhay ouyay omecay earnay emthay. \n \n<color=cyan>Eturnray otay emay onceyay ouyay avehay eptsway ethay ovegray omfray evilyay, andyay Iyay illway estowbay ayay ewardray otay ouyay...</color>\n
QUEST_SPIRALING_IN_THE_GROVE_COMPLETE_RETURN_MESSAGE	Eturnray otay Angelayay inyay Anctumsay.
QUEST_TRIGGER_SWEEPFINISHGROVENORMAL_PREFIX	Escentcray Ovegray
QUEST_TRIGGER_SWEEPFINISHGROVENORMAL_SUFFIX	Earedclay (lvyay15-20)
QUEST_TETHERING_GROVE_NAME	Etheringtay Ovegray
QUEST_TETHERING_GROVE_DESCRIPTION	Incesay ancientyay imestay, ethay Escentcray Eepkay asway eldhay inyay ighhay egardray amongstyay ouryay indkay orfay enerationsgay... \n \n<color=cyan>Enwhay ethay orldway atteredshay, ethay ausecay ofyay ethay Escentcray Eep'skay emiseday asway omfray anyay unfathomableyay orruptioncay.</color> Ethay oulssay omfray otheryay orldsway owhay ettledsay erethay idday otnay ivelay asyay onglay asyay eythay opedhay, andyay ethay uidsdray ofyay ouryay indkay ecamebay orruptcay abominationsyay.\n \n<color=yellow>Ouyay ancay indfay ethay Escentcray Ovegray eepday inyay ethay Escentcray Eepkay, atyay ethay Eastyay ingway. Ayay oorday ouldshay openyay onceyay ou'reyay earnay ityay. Indfay ethay aystray igilsay inyay ethay Escentcray Ovegray, andyay ethertay ityay otay ouryay oulsay.</color> Ethay onstersmay atthay urklay ethay ovegray areyay ightymay! Easeplay ebay eparedpray, ittlelay oneyay.\n
QUEST_TETHERING_GROVE_COMPLETE_RETURN_MESSAGE	Eturnray otay Angelayay inyay Anctumsay.
QUEST_TRIGGER_GROVESIGILTRIGGER_PREFIX	Escentcray Ovegray Igilsay
QUEST_TRIGGER_GROVESIGILTRIGGER_SUFFIX	Attunedyay
QUEST_THE_EFFOLD_TERRACE_NAME	Ethay Effoldyay Erracetay
QUEST_THE_EFFOLD_TERRACE_DESCRIPTION	Imesslay ambushedyay ouyay inyay ethay Atacombscay? Ellway enthay... it'syay ossiblepay atthay Iyay ancay uicklyqay iecepay isthay issueyay ogethertay.\n \nIthway ethay ardway estoredray byyay ouryay ovelylay oulsay, ethay ortalpay eadinglay otay ethay Effoldyay Erracetay ouldshay ebay openyay otay ouyay ownay.\n \n<color=cyan>Ethay ortalpay isyay ocatedlay ortheastnay ofyay ethay Atacombscay entranceyay.</color> Omfray atwhay Iyay eesay inyay ethay Erracetay, it'syay infestedyay ithway ilthyfay Imeksslay. Unlikeyay ordinaryyay imesslay, eythay areyay ongerstray andyay infusedyay ithway artay.\n \n<color=yellow>Ayslay 15 Imeksslay, enthay eturnray otay emay afelysay...</color>
QUEST_THE_EFFOLD_TERRACE_COMPLETE_RETURN_MESSAGE	Eturnray otay Angelayay inyay Anctumsay.
QUEST_CLEANING_TERRACE_NAME	Eaningclay Erracetay
QUEST_CLEANING_TERRACE_DESCRIPTION	Hmphyay, osethay astynay Imeksslay on'tday eemsay otay uitqay. Ethay <color=cyan>Effoldyay Erracetay</color> ouldcay enefitbay byyay omesay immediateyay eanupclay... \n \nErhapspay ouyay ouldcay oday emay ayay avorfay andyay owshay emthay ayay ittlelay orcefay ofyay ouryay illskay? <color=yellow>Ayslay aboutyay 20 Imeksslay,</color> andyay eturnray otay emay enwhay ouyay ancay...
QUEST_CLEANING_TERRACE_COMPLETE_RETURN_MESSAGE	Eturnray otay Angelayay inyay Anctumsay.
QUEST_DIVA_MUST_DIE_NAME	Ivaday Ustmay Ieday
QUEST_DIVA_MUST_DIE_DESCRIPTION	Ityay ookslay ikelay ouyay avehay oneday ayay eatgray ealday ofyay amageday otay ethay Ueen'sqay ivehay ofyay Imeksslay... Byyay ovingpray ouryay engthstray againstyay erhay eludedday offenseyay, it'syay imetay otay aketay erhay onyay ilewhay ethay ironyay isyay illstay othay.\n \nOmfray atwhay ethay eylay energiesyay atthay urroundsay ethay Erracetay uggestsay, <color=cyan>ethay Ueenqay ouldway appearyay ifyay erhay ildrenchay ontinuedcay otay ieday...</color>\n \nErhapspay erewhay erethay areyay oremay Imeksslay, atthay isyay erewhay eshay aymay ebay iddenhay. Iyay usttray atthay ouyay ancay endfay erhay offyay andyay eachtay erhay ayay essonlay, hmyay?
QUEST_DIVA_MUST_DIE_COMPLETE_RETURN_MESSAGE	Eturnray otay Angelayay inyay Anctumsay.
QUEST_RATTLECAGE_RAGE_NAME	Attlecageray Ageray
QUEST_RATTLECAGE_RAGE_DESCRIPTION	Hmyay... ohyay! Iyay understandyay atthay ethay Atacombscay aymay avehay eenbay allengingchay otay ouyay, esyay? O-Ohyay...? Onay? Ellway... inyay asecay ifyay ouyay idn'tday owknay, ityay eemssay asyay oughthay ethay Atacombscay iftsshay itsyay ormfay eachyay imetay ouyay enteryay. <color=cyan>Ethay ortalpay eadinglay intoyay emthay isyay orruptedcay, alwaysyay angingchay atwhay appenshay ithinway.</color>\n \n<i>Iyay owknay ou'reyay upyay otay ethay asktay, ittlelay oneyay...</i>\n \n<color=yellow>Eepsway outyay ethay evilyay atthay esidesray insideyay ethay Atacombscay, omfray ethay artstay otay ethay endyay.</color> Eturnray otay emay onceyay ouyay avehay oneday isthay allengechay <color=yellow>ormallynay...</color> andyay ofyay oursecay, easeplay ebay afesay.
QUEST_RATTLECAGE_RAGE_COMPLETE_RETURN_MESSAGE	Eturnray otay Angelayay inyay Anctumsay.
QUEST_TRIGGER_SWEEPFINISH_PREFIX	Atacombscay
QUEST_TRIGGER_SWEEPFINISH_SUFFIX	Earedclay (lvyay6-12)
QUEST_HUNTIN_HOGS_NAME	Untinhay' Ogshay
QUEST_HUNTIN_HOGS_DESCRIPTION	Ouryay oulsay isyay asyay ongstray asyay everyay, ittlelay oneyay. Whyyay on'tday eway tryyay omethingsay ayay ittlelay oremay... ellway, <i>aringday?</i>\n \n<color=cyan>Erethay isyay ayay allsmay assagepay uckedtay awayyay ithinway ethay Outeryay Anctumsay,</color> armingsway ithway awfulyay eaturescray ownknay asyay Ekboarsmay. Eythay andbray evastatingday eaponsway onyay eirthay eadshay, ookinglay otay ickpay ayay ightfay ithway anyoneyay owhay eadstray onyay eirthay urftay... \n \nIfyay ouyay ouldway, <color=yellow>isplayday ouryay illskay byyay ayingslay 20 Ekboarsmay andyay athergay 15 ofyay eirthay earsspay.</color>\n \nEturnray otay emay enwhay ouyay avehay...
QUEST_HUNTIN_HOGS_COMPLETE_RETURN_MESSAGE	Eturnray otay Angelayay inyay Anctumsay.
QUEST_MASTERY_OF_BLADES_NAME	Asterymay ofyay Adesblay
QUEST_MASTERY_OF_BLADES_DESCRIPTION	Ouyay eemsay otay ebay usingyay ouryay engthstray atherray ellway, ostlay oneyay. <color=yellow>Aketay isthay ollscray.</color> <color=cyan>Eadingray ityay illway allowyay ouyay otay olsterbay ouryay owerpay usingyay one-handedyay eleemay eaponsway.</color> Ocusfay ellway, andyay ouyay illway ebay ableyay otay argechay attackyay andyay umpjay attackyay againstyay ouryay enemiesyay ithway evastatingday orcefay.\n \n<color=yellow>Omecay ackbay otay emay anytimeyay ifyay ouyay econsiderray ouryay oicechay. Iyay illway ovidepray asyay anymay ollsscray asyay ouyay eednay. Ememberray atthay ouryay ollscray illway anishvay ifyay ouyay oselay ityay.</color>
QUEST_MASTERY_OF_BLADES_COMPLETE_RETURN_MESSAGE	Eturnray otay Enokyay inyay Anctumsay.
QUEST_TRIGGER_USEMELEESCROLL_PREFIX	Eleemay Asterymay Ollscray
QUEST_TRIGGER_USEMELEESCROLL_SUFFIX	eadray
QUEST_MASTERY_OF_HAMMERS_NAME	Asterymay ofyay Ammershay
QUEST_MASTERY_OF_HAMMERS_DESCRIPTION	<color=cyan>Ityay akestay immenseyay engthstray otay useyay eavyhay eaponsway, ostlay oneyay.</color> Iyay eesay atthay ouyay avehay otentialpay inyay usingyay emthay. <color=yellow>Ifyay ouyay inkthay ouyay ancay andlehay isthay urdenbay ofyay arway, aketay isthay ollscray.</color> <color=cyan>Eadingray ityay illway eachtay ouyay atwhay erethay isyay otay owknay inyay ashingsmay ouryay oesfay intoyay oodyblay iecespay.</color>\n \n<color=yellow>Omecay ackbay otay emay anytimeyay ifyay ouyay econsiderray ouryay oicechay. Iyay illway ovidepray asyay anymay ollsscray asyay ouyay eednay. Ememberray atthay ouryay ollscray illway anishvay ifyay ouyay oselay ityay.</color>
QUEST_MASTERY_OF_HAMMERS_COMPLETE_RETURN_MESSAGE	Eturnray otay Enokyay inyay Anctumsay.
QUEST_TRIGGER_USEHEAVYMELEESCROLL_PREFIX	Hyay. Eleemay Asterymay Ollscray
QUEST_TRIGGER_USEHEAVYMELEESCROLL_SUFFIX	eadray
QUEST_MASTERY_OF_SPEARS_NAME	Asterymay ofyay Earsspay
QUEST_MASTERY_OF_SPEARS_DESCRIPTION	Olearmspay ingbray emay ackbay otay ayay ostalgicnay imetay ofyay ainingtray. Uchmay ikelay otheryay eleemay eaponsway, <color=cyan>eythay areyay iablevay oolstay ofyay arway.</color> Iyay eesay ayay arkspay inyay ouryay eyeyay, ostlay oneyay. <color=yellow>Aketay isthay ollscray, asyay ityay illway eachtay ouyay otay applyyay igherhay illskay otay ouryay useyay ofyay olearmspay.</color>\n \n<color=yellow>Omecay ackbay otay emay anytimeyay ifyay ouyay econsiderray ouryay oicechay. Iyay illway ovidepray asyay anymay ollsscray asyay ouyay eednay. Ememberray atthay ouryay ollscray illway anishvay ifyay ouyay oselay ityay.</color>
QUEST_MASTERY_OF_SPEARS_COMPLETE_RETURN_MESSAGE	Eturnray otay Enokyay inyay Anctumsay.
QUEST_TRIGGER_USEPOLEARMSCROLL_PREFIX	Olearmpay Asterymay Ollscray
QUEST_TRIGGER_USEPOLEARMSCROLL_SUFFIX	eadray
QUEST_STRENGTH_AND_HONOR_NAME	Engthstray andyay Onorhay
QUEST_STRENGTH_AND_HONOR_DESCRIPTION	Ethay imetay ashay omecay otay akemay ethay ultimateyay ecisionday, ostlay oneyay. Iyay eesay atthay ethay engthstray andyay illskay ouyay avehay atheredgay ashay eenbay oremay anthay ufficentsay <color=cyan>otay ingbray orthfay ouryay uetray olorscay ofyay ecomingbay ayay Ighterfay.</color>\n \nEcomingbay ayay Ighterfay illway akemay ouyay ayay ivinglay eatthray againstyay ethay evilyay onstrositiesmay atthay oatcay isthay orldway. <color=yellow>Aketay isthay ometay.</color> Onceyay eadray, ouyay illway oinjay emay inyay ouryay effortyay otay ivideday ethay arknessday.\n \n<color=yellow>Ifyay ouyay appenhay otay oselay ouryay ometay undecidedyay, eturnray otay emay. Iyay ancay ovidepray asyay anymay asyay ouyay eednay.</color> <color=cyan>Eepkay inyay indmay, eadingray isthay ometay isyay irreversibleyay.</color>
QUEST_STRENGTH_AND_HONOR_COMPLETE_RETURN_MESSAGE	Eturnray otay Enokyay inyay Anctumsay.
QUEST_TRIGGER_GETFIGHTERCLASS_PREFIX	Ometay ofyay ethay Ighterfay
QUEST_TRIGGER_GETFIGHTERCLASS_SUFFIX	eadray
QUEST_ERADICATING_THE_UNDEAD_NAME	Eradicatingyay ethay Undeadyay
QUEST_ERADICATING_THE_UNDEAD_DESCRIPTION	Ethay imetay isyay ownay, ostlay oneyay. <color=cyan>Ethay Anctumsay Atacombscay inallyfay uncoveredyay itsyay uetray elfsay, andyay ethay omentmay otay ikestray erewhay ethay undeadyay eastlay expectyay ityay isyay erehay.</color> Asyay oolishfay andyay aimlessyay asyay eythay areyay, ethay undeadyay inyay isthay incantationyay areyay uthlessray inyay eirthay owerpay.\n \nEsethay onstrositiesmay ustmay ebay oppedstay eforebay eythay aimyay otay urtherfay orruptcay ouryay andlay. <color=yellow>Ayslay 25 Iasmamay, 15 Ellsludgehay, andyay 30 Oltergeistspay. Ouyay ancay indfay emthay inyay ethay ardesthay Anctumsay Atacombscay.</color> Etlay ethay undeadyay uffersay ouryay athwray, onay urvivorssay.\n
QUEST_ERADICATING_THE_UNDEAD_COMPLETE_RETURN_MESSAGE	Eturnray otay Enokyay inyay Anctumsay.
QUEST_PURGING_THE_GROVE_NAME	Urgingpay ethay Ovegray
QUEST_PURGING_THE_GROVE_DESCRIPTION	<color=cyan>Ethay Escentcray Ovegray isyay ayay alicemay otay isthay orldway.</color> Ethay eaturescray atthay armsway ithinway ethay ovegray areyay otnay upyay otay uffsnay otay ouryay andardsstay, ostlay oneyay. Ilencesay emthay, andyay utpay eirthay orruptedcay indsmay otay estray.\n \n<color=yellow>Estroyday 30 Eadwoodsday, 25 Arbunclescay, 10 Edray andyay Ueblay Inchroomsmay, andyay 15 Onolithsmay.</color> Eturnray otay emay atyay onceyay enwhay ouryay asktay isyay ompletedcay.\n
QUEST_PURGING_THE_GROVE_COMPLETE_RETURN_MESSAGE	Eturnray otay Enokyay inyay Anctumsay.
QUEST_REVILING_THE_RAGEBOARS_NAME	Evilingray ethay Ageboarsray
QUEST_REVILING_THE_RAGEBOARS_DESCRIPTION	Ethay Ageboarsray inyay Uultay Alleyvay areyay owardscay. Otay inkthay eythay ancay andstay ayay ancechay againstyay usyay isyay aughablelay.\n \n<color=cyan>Eepday inyay ethay Alleyvay isyay ayay empletay, overrunyay ithway ethay amnday ingsthay.</color> Esethay eviousday oarsbay ereway onstructedcay byyay anyay ominousyay evilyay eingbay atthay ashay onay emorseray orfay isthay orldway. Eway illway iscussday ofyay erhay enwhay ouryay imetay isyay eadyray, ostlay oneyay. Orfay ownay, eway ustmay ocusfay onyay atwhay ouyay ancay andlehay.\n \n<color=yellow>Ayslay 20 Ageboarsray. Eythay areyay iddenhay ithinway ethay empletay Iyay avehay okenspay ofyay, inyay Uultay Alleyvay.</color> Ebay advisedyay atthay oinggay eepday inyay ethay empletay ancay etgay ouyay illedkay ifyay ou'reyay otnay arefulcay.\n
QUEST_REVILING_THE_RAGEBOARS_COMPLETE_RETURN_MESSAGE	Eturnray otay Enokyay inyay Anctumsay.
QUEST_THE_COLOSSUS_NAME	Ethay Olossuscay
QUEST_THE_COLOSSUS_DESCRIPTION	Iyay eesay atthay ouyay avehay alignedyay ourselfyay ellway againstyay ethay oesfay inyay Escentcray Eepkay. Oodgay orkway, ostlay oneyay. <color=cyan>Ityay isyay imetay ownay otay aketay ayay epstay urtherfay eyondbay ethay Eepkay, otay ethay Escentcray Ovegray.</color> Atwhay ouyay illway itnessway erethay isyay ayay oulfay armsway ofyay arkday agicsmay, ithway anymay ofyay ouryay allenfay indkay omfray agesyay astpay embracingyay ethay orruptioncay.\n \nErethay areyay otway othersbray, omwhay Iyay asway onceyay amiliarfay ithway. Eythay areyay ownay ickedway Arbunclescay, eetingmay ethay amesay atefay ethay othersyay avehay. <color=cyan>Ethay othersbray eatedcray ayay olemgay, oneyay atthay isyay apablecay ofyay earingtay ethay orldway asunderyay.</color> Eway ustmay utpay anyay endyay otay eirthay owardicecay. <color=yellow>Estroyday ethay Olossuscay, enthay eturnray otay emay.</color>\n \n<color=yellow>Ifyay ouyay aven'thay oneday osay, eakspay otay Angelayay. Eshay ancay uidegay ouyay otay ethay Escentcray Ovegray.</color>\n
QUEST_THE_COLOSSUS_COMPLETE_RETURN_MESSAGE	Eturnray otay Enokyay inyay Anctumsay.
QUEST_PURGING_THE_UNDEAD_NAME	Urgingpay ethay Undeadyay
QUEST_PURGING_THE_UNDEAD_DESCRIPTION	<color=cyan>Ethay Anctumsay Atacombscay isyay ayay evernay endingyay ellscapehay, ivendray inyay ayay oalgay otay ingbray Anctumsay otay itsyay eesknay.</color> Ortunatelyfay orfay usyay, ey'rethay ootay upidstay otay ealizeray owhay ey'rethay ealingday ithway. Ethay amountyay ofyay atiencepay Iyay avehay ithway esethay atheticpay eaturescray isyay unningray inthay.\n \n<color=cyan>Ithway ethay ivledgepray ofyay myyay engthstray imbuedyay ithway ouryay oulsay, eway ancay akemay ethay undeadyay eamscray inyay agonyyay ogethertay.</color> <color=yellow>Ayslay 25 Oxinstay, 15 Eathgelsday, andyay 30 Eistsgay. Ouyay ancay indfay emthay inyay ethay ormalnay Anctumsay Atacombscay.</color> Isthay ouldshay ebay ayay umouroushay eminderray orfay ethay undeadyay otay owknay exactlyyay owhay ontrolscay isthay andlay.\n
QUEST_PURGING_THE_UNDEAD_COMPLETE_RETURN_MESSAGE	Eturnray otay Enokyay inyay Anctumsay.
QUEST_THE_VOICE_OF_ZUULNERUDA_NAME	Ethay Oicevay ofyay Uulnerudazay
QUEST_THE_VOICE_OF_ZUULNERUDA_DESCRIPTION	Istenlay. <i>Oday ouyay earhay ityay?</i> Ere'sthay ayay aintfay oundsay ofyay aughterlay inyay ethay istanceday, omingcay omfray ethay Atacombscay. <color=cyan>Ithinway ityay isyay anyay entityyay atthay isyay ethay anifestationmay atthay ontinuescay otay eanimateray ethay eadday.</color>\n \n<color=cyan>Isthay entityyay isyay amednay Ordlay Uulnerudazay.</color> Ayay "Eistlordgay", oneyay ofyay ethay igherhay elitesyay inyay ethay undeadyay anksray. Ehay ustmay ebay urgedpay. <color=yellow>Eeksay Uulnerudazay, andyay illkay imhay. Ehay isyay iddenhay ithinway ethay ediummay ayerlay ofyay ethay orruptedcay ortalpay.</color>\n \nUrryhay, ostlay oneyay... imetay isyay ofyay ethay essenceyay. <color=yellow>Eturnray otay emay enwhay ishay oodblay isyay inyay ouryay andshay.</color>\n \n<color=cyan>[Efeatday Ordlay Uulnerudazay inyay ethay (LVyay6-12) Anctumsay Atacombscay.]</color>
QUEST_THE_VOICE_OF_ZUULNERUDA_COMPLETE_RETURN_MESSAGE	Eturnray otay Enokyay inyay Anctumsay.
QUEST_GHOSTLY_GOODS_NAME	Ostlyghay Oodsgay
QUEST_GHOSTLY_GOODS_DESCRIPTION	Owy'knay, Iyay ouldcay useyay omethinsay' ofyay ouryay elphay, ifyay ayay on'tday indmay! <color=cyan>Ifyay ou'reyay upyay otay ityay, I'llyay etlay ouyay inyay onyay ayay ecretsay ootay-- utbay eepkay ityay onyay ethay ushhay ushhay!</color>\n \nI'myay ookinlay' orfay ayay ecialspay ombinationcay ofyay ostlyghay oodsgay, <color=cyan>ethay etypay atthay ancay ebay ixedmay intoyay ayay inefay illay' owderpay atthay akesmay ouyay invisibleyay!</color> \n \nIfyay ayay ouldcay, <color=yellow>etchfay emay omesay Ostdustsghay omfray emthay undeadyay ellasfay, andyay ayay andfulhay ofyay osethay eirdway illay' ollarscay ethay Eistsgay earway omfray ethay Atacombscay!</color>\n \nOmecay ackbay enwhay ayay otgay ayay oodgay amountyay ofyay emyay', ayay earhay?
QUEST_GHOSTLY_GOODS_COMPLETE_RETURN_MESSAGE	Eturnray otay Allysay inyay Anctumsay.
QUEST_SUMMORE_SPECTRAL_POWDER_NAME	Ummoresay' Ectralspay Owderpay!
QUEST_SUMMORE_SPECTRAL_POWDER_DESCRIPTION	Mmm-hmyay! At'dwhay ayay inkthay ofyay atthay owderpay, unhay? Ettypray iftynay, <i>ightray?</i>\n \nAysay, ifyay ayay antway ummoresay, owhay outbay' ouyay etchfay omesay Ostdustghay andyay Eistgay Ollarscay? Iyay on'tway ebay eedinnay' asyay anymay asyay eforebay. <color=cyan>Eepinkay' indmay-- ethay Anctumsay Atacombscay isyay ethay estbay aceplay otay etgay ethay uffstay!</color>\n \n<color=yellow>Ingbray emay... aboutyay 20 Ostdustsghay andyay 8 Eistgay Ollarscay,</color> andyay I'llyay ipwhay upyay othernay' atchbay orfay ayay! <i>I'llyay akemay ityay iggerbay ootay.</i>
QUEST_SUMMORE_SPECTRAL_POWDER_COMPLETE_RETURN_MESSAGE	Eturnray otay Allysay inyay Anctumsay.
QUEST_DEVIOUS_PACT_NAME	Eviousday Actpay
QUEST_DEVIOUS_PACT_DESCRIPTION	Ellway ooklay atyay atthay! Aven'thay ayay eenbay usybay? <color=cyan>I'veyay eenbay eaninmay' otay etlay ayay inyay onyay omethinsay', utbay it'llyay onlyyay ebay etweenbay usyay andyay ayay arespay ewfay!</color>\n \nIyay aketay ityay ayay ikelay inyshay ingsthay-- oinscay andyay ootlay? Oryay aybemay isorientingday ouryay oesfay? Iyay ancay elphay ayay ithway atthay... <color=cyan>Elievebay ityay oryay otnay, Iyay amyay ethay Anditbay Uardiangay!</color> Eway allyay orkway ardhay orfay ouryay usinessbay, <i>evenyay ifyay ityay akestay ertaincay ethodsmay otay etgay ouryay ayway.</i>\n \n<color=yellow>Aketay isthay, andyay onsidercay oiningjay emay andyay myyay ewcray! Eepinkay' indmay ayay an'tcay evertray ouryay oicechay. Ifyay ayay oselay ouryay ometay, omecay ackbay againyay!</color>
QUEST_DEVIOUS_PACT_COMPLETE_RETURN_MESSAGE	Eturnray otay Allysay inyay Anctumsay.
QUEST_TRIGGER_GETBANDITCLASS_PREFIX	Ometay ofyay ethay Anditbay
QUEST_TRIGGER_GETBANDITCLASS_SUFFIX	eadray
QUEST_MAKIN_A_VILE_BLADE_NAME	Akinmay' ayay Ilevay Adeblay
QUEST_MAKIN_A_VILE_BLADE_DESCRIPTION	<color=cyan>Ou'veyay eenbay atyay ethay Escentcray Eepkay, ightray?</color> Astlay I'veyay eardhay, atthay aceplay isyay arminsway' ithway osethay illay' alitosis-riddenhay itterscray! E'reway otnay uresay atwhay otay allcay emyay', <color=cyan>osay eway ustjay allcay emyay' Outhsmay otay eepkay ingsthay implesay.</color>\n \nAybemay eway ancay akemay omethinsay' ustjay otay ivegay emthay ayay astetay ofyay eirthay ownyay eathbray! <color=yellow>Ingbray emay ayay Uderay Adeblay, 5 Outhmay Itterteethbay, 3 Imekslay Eyesyay, andyay 10 Eathgelday Orescay!</color> E'llway akemay atthay adeblay asyay ilevay asyay eythay areyay, unhay!\n \n<color=cyan>Ouyay ancay indfay ayay Uderay Adeblay inyay ethay Escentcray Eepkay, Imeksslay inyay ethay Effoldyay Erracetay, andyay Eathgelsday inyay ethay ormalnay Anctumsay Atacombscay!</color>\n \n
QUEST_MAKIN_A_VILE_BLADE_COMPLETE_RETURN_MESSAGE	Eturnray otay Allysay inyay Anctumsay.
QUEST_MAKIN_A_WIZWAND_NAME	Akinmay' ayay Izwandway
QUEST_MAKIN_A_WIZWAND_DESCRIPTION	<color=cyan>Ayay everyay eesay osethay angestray Izboarsway, unhay?</color> Osethay ellasfay alwaysyay ooklay osay appyhay. Elievebay emay oughthay, ey'rethay iciousvay illay' ingsthay!\n \nAybemay eway ancay uildbay ayay allersmay, utbay easieryay otay useyay epterscay atthay unctionsfay ikelay oneyay ofyay eirsthay, eahyay? <color=yellow>Ingbray emay 1 Izboarway Epterscay, 5 Ightwoodblay Icksstay andyay 5 Ightwoodblay Ogslay!</color> Ayay upyay otay ityay?\n
QUEST_MAKIN_A_WIZWAND_COMPLETE_RETURN_MESSAGE	Eturnray otay Allysay inyay Anctumsay.
QUEST_MAKIN_MORE_VILE_BLADES_NAME	Akinmay' Oremay Ilevay Adesblay
QUEST_MAKIN_MORE_VILE_BLADES_DESCRIPTION	<color=cyan>Eadyray otay akemay anotheryay Ilevay Adeblay?</color> Alrightyay!\n \n<color=yellow>Ingbray emay ayay Uderay Adeblay, 5 Outhmay Itterteethbay, 3 Imekslay Eyesyay, andyay 10 Eathgelday Orescay!</color>\n \n<color=cyan>Ouyay ancay indfay ayay Uderay Adeblay inyay ethay Escentcray Eepkay, Imeksslay inyay ethay Effoldyay Erracetay, andyay Eathgelsday inyay ethay ormalnay Anctumsay Atacombscay!</color>\n \n
QUEST_MAKIN_MORE_VILE_BLADES_COMPLETE_RETURN_MESSAGE	Eturnray otay Allysay inyay Anctumsay.
QUEST_MAKIN_MORE_WIZWANDS_NAME	Akinmay' Oremay Izwandsway
QUEST_MAKIN_MORE_WIZWANDS_DESCRIPTION	<color=cyan>Interestedyay inyay akinmay' anotheryay Izwandway?</color> Eway ancay oday atthay! It'llyay aketay ethay amesay amountyay ofyay uffstay, <i>uustjay</i> ettinlay' ayay owknay.\n \n<color=yellow>Ingbray emay 1 Izboarway Epterscay, 5 Ightwoodblay Icksstay andyay 5 Ightwoodblay Ogslay!</color> E'llway etgay ayay overedcay.\n \n
QUEST_MAKIN_MORE_WIZWANDS_COMPLETE_RETURN_MESSAGE	Eturnray otay Allysay inyay Anctumsay.
QUEST_MASTERY_OF_KATARS_NAME	Asterymay ofyay Atarskay
QUEST_MASTERY_OF_KATARS_DESCRIPTION	Hmyay! Ellway ouldn'tway ayay owknay? Iyay idn'tday inkthay' I'dyay ebay offeringyay uchsay ayay ingthay, utbay I'llyay etlay ouyay inyay onyay ityay. \n \nAyway ackbay enthay, Iyay asway alwaysyay ightinfay' otay ominateday inyay ethay usinessbay, akinmay' uresay ingsthay ereway ettingay' akentay arecay ofyay. <color=cyan>Inyay atthay imetay, Iyay usedyay ecialspay echniquestay usinyay' atarskay!</color> Arpshay illay' ingsthay, ableyay otay iceslay andyay ockknay outyay ompetitioncay inyay ayay eartbeathay!\n \nIfyay ou'dyay ebay interestedyay inyay owingknay omesay ofyay atthay illskay, Iyay ancay eachtay ayay! <color=yellow>Aketay isthay ollscray. It'llyay ivegay ayay ethay oostbay ou'dyay eednay otay ummelpay emthay untsray intoyay ethay irtday!</color>\n \n<color=yellow>Inyay asecay ayay annaway inkthay' ityay overyay icetway, I'myay alwaysyay erehay otay ivegay anotheryay ollscray ifyay ayay eednay ityay! Ustjay owknay atthay ethay ollscray illway anishvay ifyay ayay opdray ityay, ayay earhay?</color>
QUEST_MASTERY_OF_KATARS_COMPLETE_RETURN_MESSAGE	Eturnray otay Allysay inyay Anctumsay.
QUEST_TRIGGER_USEKATARSCROLL_PREFIX	Atarkay Asterymay Ollscray
QUEST_TRIGGER_USEKATARSCROLL_SUFFIX	eadray
QUEST_MASTERY_OF_RANGE_NAME	Asterymay ofyay Angeray
QUEST_MASTERY_OF_RANGE_DESCRIPTION	<color=cyan>Everyay oughtthay ou'dyay ebay interestedyay inyay ethay ow-howknay onyay usinyay' angedray eaponsway?</color> Ityay aymay omecay asyay ayay ockshay otay ouyay unhay, utbay Iyay owknay myyay ayway aroundyay usinyay' emyay andyay akintay' ownday ingsthay enwhay ethay objay eedsnay otay ebay oneday! Angedray eaponsway avehay eenbay ayay ifesaverlay orfay emay andyay myyay ewcray!\n \nIfyay ou'dyay ebay interestedyay inyay owingknay omesay ofyay atthay illskay, Iyay ancay eachtay ayay! <color=yellow>Aketay isthay ollscray. Earninlay' ityay ancay ivegay ouyay ethay abilityyay otay useyay angedray eaponsway atyay eirthay estbay otentialpay!</color>\n \n<color=yellow>Inyay asecay ayay annaway inkthay' ityay overyay icetway, I'myay alwaysyay erehay otay ivegay anotheryay ollscray ifyay ayay eednay ityay! Ustjay owknay atthay ethay ollscray illway anishvay ifyay ayay opdray ityay, ayay earhay?</color>
QUEST_MASTERY_OF_RANGE_COMPLETE_RETURN_MESSAGE	Eturnray otay Allysay inyay Anctumsay.
QUEST_TRIGGER_USERANGEDSCROLL_PREFIX	Angedray Asterymay Ollscray
QUEST_TRIGGER_USERANGEDSCROLL_SUFFIX	eadray
QUEST_MAKIN_A_GOLEM_CHESTPIECE_NAME	Akinmay' ayay Olemgay Estpiecechay
QUEST_MAKIN_A_GOLEM_CHESTPIECE_DESCRIPTION	<color=cyan>Emthay Olemsgay inyay Escentcray Eepkay areyay ongstray uggersbay!</color> Aybemay eway ancay aketay eirthay orescay andyay emsgay, akemay omethinsay' eatnay outtayay ityay! It'dyay ebay ayay estpiecechay, ayay ettypray ongstray oneyay ootay!\n \n<color=yellow>Ingbray onyay overyay 10 Olemgay Orescay, andyay 15 Olemgay Emsgay,</color> andyay e'llway etgay atthay estpiecechay ademay!\n
QUEST_MAKIN_A_GOLEM_CHESTPIECE_COMPLETE_RETURN_MESSAGE	Eturnray otay Allysay inyay Anctumsay.
QUEST_SUMMORE_GOLEM_CHESTPIECES_NAME	Ummoresay' Olemgay Estpieceschay
QUEST_SUMMORE_GOLEM_CHESTPIECES_DESCRIPTION	Ohyay? <color=cyan>Ookinlay' otay akemay anotheryay Olemgay Estpiecechay?</color> I'myay onnagay ebay eedinnay' ethay amesay aterialsmay orfay ityay enthay, unhay!\n \n<color=yellow>Ingbray onyay overyay 10 Olemgay Orescay andyay 15 Olemgay Emsgay,</color> andyay e'llway etgay atthay estpiecechay ademay!\n
QUEST_SUMMORE_GOLEM_CHESTPIECES_COMPLETE_RETURN_MESSAGE	Eturnray otay Allysay inyay Anctumsay.
QUEST_MAKIN_A_RAGESPEAR_NAME	Akinmay' ayay Agespearray
QUEST_MAKIN_A_RAGESPEAR_DESCRIPTION	Hmyay, epyay! Ayay ademay ayay Ekspearmay eforebay, Iyay ememberray! <color=cyan>Annaway aketay ityay otay ethay extnay evellay? Owy'knay, eway ouldcay...</color>\n \n<color=yellow>Eadhay onyay overyay otay Uultay Alleyvay, andyay anglewray emthay Ageboarsray orfay oneyay ofyay eirthay earsspay!</color> Ey'rethay ayay illay' oughertay anthay atwhay ou'veyay oughtfay eforebay, osay aystay ocusedfay, unhay!\n \n<color=yellow>I'llyay eednay omesay ellsludgehay orescay ootay, outbay' 15 ofyay emthay, otay eepkay ityay allyay ogethertay. Ey'rethay omfray emthay Ellsludgeshay inyay ethay ardesthay Anctumsay Atacombscay. Akemay uresay ayay otgay ayay Ekspearmay onyay andhay ootay!</color>
QUEST_MAKIN_A_RAGESPEAR_COMPLETE_RETURN_MESSAGE	Eturnray otay Allysay inyay Anctumsay.
QUEST_MAKIN_MORE_RAGESPEARS_NAME	Akinmay' Oremay Agespearsray
QUEST_MAKIN_MORE_RAGESPEARS_DESCRIPTION	<color=cyan>Ookinlay' otay akemay anotheryay Agespearray, unhay?</color> Alrightyay! Ere'shay atwhay e'reway onnagay' eednay:\n \n<color=yellow>1 Ekspearmay, 1 Ageboarray Earspay, andyay 15 Ellsludgehay Orescay!</color>\n \n<color=cyan>Ayay ancay indfay emthay Ageboarsray inyay Uultay Alleyvay, andyay Ellsludgeshay inyay ethay ardesthay Anctumsay Atacombscay.</color> Oodluckgay!
QUEST_MAKIN_MORE_RAGESPEARS_COMPLETE_RETURN_MESSAGE	Eturnray otay Allysay inyay Anctumsay.
QUEST_MAKIN_A_MONOLITH_CHESTPIECE_NAME	Akinmay' ayay Onolithmay Estpiecechay
QUEST_MAKIN_A_MONOLITH_CHESTPIECE_DESCRIPTION	<color=cyan>Illstay otgay atthay illay' Olemgay Estpiecechay eway ademay ayay ilewhay ackbay?</color> Emmelay elltay ayay, ere'sthay ayay ayway otay akemay ityay <i>evenyay etterbay!</i>\n \n<color=cyan>Inyay ethay Escentcray Ovegray, ere'sthay ayay uchmay, uchmay ongerstray etypay ofyay Olemgay atthay ellsdway erethay.</color> Eythay areyay omesay ealray astynay uggersbay!\n \nEt'slay akemay ayay ongstray estpiecechay outtayay eirthay aterialsmay! <color=yellow>Ingbray emay... ayay Olemgay Estpiecechay, 15 Onolithmay Orescay,  10 Onolithmay Emsgay, andyay astlylay, 5 Ursedcay Otesnay omfray emthay Arbunclescay inyay ethay Ovegray!</color>\n \n<i>Addyawhay aysay?</i>\n
QUEST_MAKIN_A_MONOLITH_CHESTPIECE_COMPLETE_RETURN_MESSAGE	Eturnray otay Allysay inyay Anctumsay.
QUEST_SUMMORE_MONOLITH_CHESTPIECES_NAME	Ummoresay' Onolithmay Estpieceschay
QUEST_SUMMORE_MONOLITH_CHESTPIECES_DESCRIPTION	Ahyay! Ookinlay' orfay anotheryay Onolithmay Estpiecechay, hmyay? Okayyay! Ere'shay atwhay e'llway eednay orfay ityay:\n \n <color=yellow>Ingbray emay... ayay Olemgay Estpiecechay, 15 Onolithmay Orescay,  10 Onolithmay Emsgay, andyay astlylay, 5 Ursedcay Otesnay omfray emthay Arbunclescay inyay ethay Ovegray!</color>\n \n<i>Addyawhay aysay?</i>\n
QUEST_SUMMORE_MONOLITH_CHESTPIECES_COMPLETE_RETURN_MESSAGE	Eturnray otay Allysay inyay Anctumsay.
QUEST_MAKIN_A_MEKSPEAR_NAME	Akinmay' ayay Ekspearmay
QUEST_MAKIN_A_MEKSPEAR_DESCRIPTION	Eyahay unhay'! <color=cyan>I'veyay eenbay inkinthay' ofyay omethinsay eway ouldcay akemay. Erhapspay omethinsay' ikelay ayay owerfulpay earspay!</color> Owy'knay, emthay Ekboarsmay ooklay ikelay eythay otgay omethinsay iercefay ithway emthay earsspay onyay eirthay illay' eadshay.\n \nOwhay outbay isthay, ivegay emay... aysay, <color=yellow>1 earspay omfray emthay Ekboarsmay, andyay 15 Imekslay Orescay otay eepkay ityay allyay ogethertay.</color> I'llyay akemay ayay icenay artisanpay orfay ayay inyay eturnray. Oundsay oodgay?\n
QUEST_MAKIN_A_MEKSPEAR_COMPLETE_RETURN_MESSAGE	Eturnray otay Allysay inyay Anctumsay.
QUEST_MAKIN_MORE_MEKSPEARS_NAME	Akinmay' Oremay Ekspearsmay
QUEST_MAKIN_MORE_MEKSPEARS_DESCRIPTION	<color=cyan>Ookinlay' otay akemay anotheryay Ekspearmay?</color> Ellway, alrightyay enthay!\n \nOwy'knay ethay illdray! I'llyay eednay... <color=yellow>1 earspay omfray emthay Ekboarsmay andyay 15 Imekslay Orescay otay eepkay ityay ogethertay,</color> andyay I'llyay akemay ayay icenay artisanpay orfay ayay inyay eturnray. Oundsay oodgay?\n
QUEST_MAKIN_MORE_MEKSPEARS_COMPLETE_RETURN_MESSAGE	Eturnray otay Allysay inyay Anctumsay.
CONDITION_BURN_NAME	Urnbay
CONDITION_BURN_1_DESCRIPTION	Urningbay.
CONDITION_COLD_NAME	Oldcay
CONDITION_COLD_1_DESCRIPTION	Aredsnay.
CONDITION_GASH_NAME	Ashgay
CONDITION_GASH_1_DESCRIPTION	Eedingblay 3 amageday everyyay 0.4 ecsay.
CONDITION_POISON_NAME	Oisonpay
CONDITION_POISON_1_DESCRIPTION	Oisonedpay.
CONDITION_VILEBLADE_POISON_NAME	Ilebladevay Oisonpay
CONDITION_VILEBLADE_POISON_1_DESCRIPTION	Oisonedpay.
CONDITION_WEAKENING_NAME	Eakeningway
CONDITION_WEAKENING_0_DESCRIPTION	Efenseday oweredlay byyay 5.
CONDITION_CYRO_SLOW_NAME	Ocyray Owslay
CONDITION_CYRO_SLOW_0_DESCRIPTION	Oldcay. Ovementmay owedslay ownday.
CONDITION_DEFENSE_POTION_NAME	Efenseday Otionpay
CONDITION_DEFENSE_POTION_0_DESCRIPTION	Efenseday increasedyay byyay 5.
CONDITION_DEFENSE_POTION_1_DESCRIPTION	Efenseday increasedyay byyay 10.
CONDITION_EVASION_POTION_NAME	Evasionyay Otionpay
CONDITION_EVASION_POTION_0_DESCRIPTION	Evasionyay increasedyay byyay 3%.
CONDITION_EVASION_POTION_1_DESCRIPTION	Evasionyay increasedyay byyay 5%.
CONDITION_EVASION_POTION_2_DESCRIPTION	Evasionyay increasedyay byyay 7%.
CONDITION_MGK_DEFENSE_POTION_NAME	Mgkyay. Efenseday Otionpay
CONDITION_MGK_DEFENSE_POTION_0_DESCRIPTION	Agicmay Efenseday increasedyay byyay 5.
CONDITION_MGK_DEFENSE_POTION_1_DESCRIPTION	Agicmay Efenseday increasedyay byyay 10.
CONDITION_REGENERATION_POTION_NAME	Egenerationray Otionpay
CONDITION_REGENERATION_POTION_0_DESCRIPTION	Egeneratingray 3 ealthhay.
CONDITION_REGENERATION_POTION_1_DESCRIPTION	Egeneratingray 8 ealthhay.
CONDITION_SPECTRAL_POWDER_NAME	Ectralspay Owderpay
CONDITION_SPECTRAL_POWDER_0_DESCRIPTION	Anishedvay. Ancelscay onyay attackyay, oryay ifyay ithay.
CONDITION_WISP_CURSE_NAME	Ispway Ursecay
CONDITION_WISP_CURSE_1_DESCRIPTION	Ecreasesday allyay owerpay atsstay byyay 2.
CONDITION_WISP_CURSE_2_DESCRIPTION	Ecreasesday allyay owerpay atsstay byyay 5.
CONDITION_WISP_CURSE_3_DESCRIPTION	Ecreasesday allyay owerpay atsstay byyay 10.
CONDITION_WISP_CURSE_4_DESCRIPTION	Iphonedsay orfay 5 ealthhay.
CONDITION_EXECUTE_NAME	Executeyay
CONDITION_EXECUTE_1_DESCRIPTION	
CONDITION_BOUNCE_NAME	Ouncebay
CONDITION_BOUNCE_1_DESCRIPTION	Evasionyay increasedyay byyay 100%.
CONDITION_DEVIOUS_SIGNET_NAME	Eviousday Ignetsay
CONDITION_DEVIOUS_SIGNET_1_DESCRIPTION	Evasionyay andyay iticalcray ikestray anceschay increasedyay byyay 5%. Axmay aminastay increasedyay byyay 5.
CONDITION_DEVIOUS_SIGNET_2_DESCRIPTION	Evasionyay andyay iticalcray ikestray anceschay increasedyay byyay 5%. Axmay aminastay increasedyay byyay 10.
CONDITION_DEVIOUS_SIGNET_3_DESCRIPTION	Evasionyay andyay iticalcray ikestray anceschay increasedyay byyay 10%. Axmay aminastay increasedyay byyay 10.
CONDITION_DEVIOUS_SIGNET_4_DESCRIPTION	Evasionyay andyay iticalcray ikestray anceschay increasedyay byyay 10%. Axmay aminastay increasedyay byyay 15.
CONDITION_DEVIOUS_SIGNET_5_DESCRIPTION	Evasionyay andyay iticalcray ikestray anceschay increasedyay byyay 15%. Axmay aminastay increasedyay byyay 15.
CONDITION_DEVIOUS_SIGNET_6_DESCRIPTION	Evasionyay andyay iticalcray ikestray anceschay increasedyay byyay 15%. Axmay aminastay increasedyay byyay 20.
CONDITION_KILLER_JAB_NAME	Illerkay Abjay
CONDITION_KILLER_JAB_1_DESCRIPTION	Efenseday ecreasedday byyay 10. Ovementmay eedspay ecreasedday byyay 20%.
CONDITION_MIST_VEIL_NAME	Istmay Eilvay
CONDITION_MIST_VEIL_1_DESCRIPTION	Antsgray invisibilityyay andyay ealshay 5 ealthhay everyyay 1.2 econdssay. Attackingyay illway emoveray ethay effectyay.
CONDITION_MIST_VEIL_2_DESCRIPTION	Antsgray invisibilityyay andyay ealshay 5 ealthhay everyyay 1.2 econdssay. Attackingyay illway emoveray ethay effectyay.
CONDITION_MIST_VEIL_3_DESCRIPTION	Antsgray invisibilityyay andyay ealshay 5 ealthhay everyyay 1.2 econdssay. Attackingyay illway emoveray ethay effectyay.
CONDITION_MIST_VEIL_4_DESCRIPTION	Antsgray invisibilityyay andyay ealshay 5 ealthhay everyyay 1.2 econdssay. Attackingyay illway emoveray ethay effectyay.
CONDITION_PAY_DAY_NAME	Aypay Ayday
CONDITION_PAY_DAY_1_DESCRIPTION	Unnedstay andyay uggedmay byyay ayay Anditbay.
CONDITION_PAY_DAY_2_DESCRIPTION	Unnedstay andyay uggedmay byyay ayay Anditbay.
CONDITION_PAY_DAY_3_DESCRIPTION	Unnedstay andyay uggedmay byyay ayay Anditbay.
CONDITION_PAY_DAY_4_DESCRIPTION	Unnedstay andyay uggedmay byyay ayay Anditbay.
CONDITION_VENOM_SHOT_NAME	Enomvay Otshay
CONDITION_VENOM_SHOT_1_DESCRIPTION	Oisonedpay. Efenseday ecreasedday byyay 3.
CONDITION_VENOM_SHOT_2_DESCRIPTION	Oisonedpay. Efenseday ecreasedday byyay 6.
CONDITION_VENOM_SHOT_3_DESCRIPTION	Oisonedpay. Efenseday ecreasedday byyay 9.
CONDITION_VENOM_SHOT_4_DESCRIPTION	Oisonedpay. Efenseday ecreasedday byyay 12.
CONDITION_VENOM_SHOT_5_DESCRIPTION	Oisonedpay. Efenseday ecreasedday byyay 15.
CONDITION_VENOM_SHOT_6_DESCRIPTION	Oisonedpay. Efenseday ecreasedday byyay 18.
CONDITION_BLOOD_GUSH_NAME	Oodblay Ushgay
CONDITION_BLOOD_GUSH_1_DESCRIPTION	Eedingblay.
CONDITION_BLOOD_GUSH_2_DESCRIPTION	Eedingblay.
CONDITION_BLOOD_GUSH_3_DESCRIPTION	Eedingblay.
CONDITION_BLOOD_GUSH_4_DESCRIPTION	Eedingblay.
CONDITION_LETHAL_STRIKE_NAME	Ethallay Ikestray
CONDITION_LETHAL_STRIKE_1_DESCRIPTION	Evasionyay increasedyay byyay 100%.
CONDITION_RAGE_NAME	Ageray
CONDITION_RAGE_1_DESCRIPTION	Allyay owerpay Atsstay increasedyay byyay <color=yellow>5.</color>
CONDITION_RAGE_2_DESCRIPTION	Allyay owerpay Atsstay increasedyay byyay <color=yellow>8.</color>
CONDITION_RAGE_3_DESCRIPTION	Allyay owerpay Atsstay increasedyay byyay <color=yellow>15.</color>
CONDITION_RAGE_4_DESCRIPTION	Allyay owerpay Atsstay increasedyay byyay <color=yellow>20.</color>
CONDITION_RAGE_5_DESCRIPTION	Allyay owerpay Atsstay increasedyay byyay <color=yellow>25.</color>
CONDITION_RAGE_6_DESCRIPTION	Allyay owerpay Atsstay increasedyay byyay <color=yellow>32.</color>
CONDITION_SHIELD_BASH_NAME	Ieldshay Ashbay
CONDITION_SHIELD_BASH_1_DESCRIPTION	Unnedstay.
CONDITION_SHIELD_BASH_2_DESCRIPTION	Unnedstay.
CONDITION_SHIELD_BASH_3_DESCRIPTION	Unnedstay.
CONDITION_SHIELD_BASH_4_DESCRIPTION	Unnedstay.
CONDITION_STOMP_NAME	Ompstay
CONDITION_STOMP_1_DESCRIPTION	Owedslay byyay 25%. Efenseday oweredlay byyay 15.
CONDITION_BLINK_NAME	Inkblay
CONDITION_BLINK_1_DESCRIPTION	Inkedblay.
CONDITION_CROSS_FLASH_NAME	Osscray Ashflay
CONDITION_CROSS_FLASH_1_DESCRIPTION	Ecreasesday Agicmay Efenseday byyay 5.
CONDITION_CROSS_FLASH_2_DESCRIPTION	Ecreasesday Agicmay Efenseday byyay 10.
CONDITION_CROSS_FLASH_3_DESCRIPTION	Ecreasesday Agicmay Efenseday byyay 15.
CONDITION_CROSS_FLASH_4_DESCRIPTION	Ecreasesday Agicmay Efenseday byyay 20.
CONDITION_FLUXSPEAR_NAME	Uxspearflay
CONDITION_FLUXSPEAR_1_DESCRIPTION	Unnedstay.
CONDITION_FLUXSPEAR_2_DESCRIPTION	Unnedstay.
CONDITION_FLUXSPEAR_3_DESCRIPTION	Unnedstay.
CONDITION_FLUXSPEAR_4_DESCRIPTION	Unnedstay.
CONDITION_IMBUE_NAME	Imbueyay
CONDITION_IMBUE_1_DESCRIPTION	Agicmay Owerpay increasedyay byyay 5, Agicmay Efenseday byyay 5, andyay Axmay Anamay increasedyay byyay 10.
CONDITION_IMBUE_2_DESCRIPTION	Agicmay Owerpay increasedyay byyay 10, Agicmay Efenseday byyay 5, andyay Axmay Anamay increasedyay byyay 10.
CONDITION_IMBUE_3_DESCRIPTION	Agicmay Owerpay increasedyay byyay 15, Agicmay Efenseday byyay 10, andyay Axmay Anamay increasedyay byyay 20.
CONDITION_IMBUE_4_DESCRIPTION	Agicmay Owerpay increasedyay byyay 20, Agicmay Efenseday byyay 10, andyay Axmay Anamay increasedyay byyay 20.
CONDITION_IMBUE_5_DESCRIPTION	Agicmay Owerpay increasedyay byyay 25, Agicmay Efenseday byyay 15, andyay Axmay Anamay increasedyay byyay 25.
CONDITION_PRISM_NAME	Ismpray
CONDITION_PRISM_1_DESCRIPTION	Absorbsyay upyay otay 10 amageday.
CONDITION_PRISM_2_DESCRIPTION	Absorbsyay upyay otay 20 amageday.
CONDITION_PRISM_3_DESCRIPTION	Absorbsyay upyay otay 30 amageday.
CONDITION_PRISM_4_DESCRIPTION	Absorbsyay upyay otay 40 amageday.
CONDITION_PRISM_5_DESCRIPTION	Absorbsyay upyay otay 50 amageday.
CONDITION_RESTORA_NAME	Estoraray
CONDITION_RESTORA_1_DESCRIPTION	Ealedhay byyay Estoraray.
CONDITION_ALACRITY_NAME	Alacrityyay
CONDITION_ALACRITY_1_DESCRIPTION	Ethay extnay illskay isyay instantyay ithway onay ostcay otay anamay, ealthhay oryay aminastay asedbay illsskay.
CONDITION_INNER_FOCUS_NAME	Inneryay Ocusfay
CONDITION_INNER_FOCUS_1_DESCRIPTION	Ethay extnay icalphysay oryay agicmay attackyay illway ebay ayay 100% itcray ancechay.
CONDITION_LEG_UP_NAME	Eglay Upyay
CONDITION_LEG_UP_1_DESCRIPTION	Ovementmay eedspay increasedyay byyay <color=yellow>20%.</color> Evasionyay increasedyay byyay <color=yellow>12%.</color>
CONDITION_LEG_UP_2_DESCRIPTION	Ovementmay eedspay increasedyay byyay <color=yellow>30%.</color> Evasionyay increasedyay byyay <color=yellow>14%.</color>
CONDITION_LEG_UP_3_DESCRIPTION	Ovementmay eedspay increasedyay byyay <color=yellow>40%.</color> Evasionyay increasedyay byyay <color=yellow>16%.</color>
CONDITION_RECALL_NAME	Ecallray
CONDITION_RECALL_0_DESCRIPTION	
CONDITION_RECOVERY_NAME	Ecoveryray
CONDITION_RECOVERY_1_DESCRIPTION	Ealshay <color=yellow>3</color> ealthhay everyyay 2 econdssay.
CONDITION_RECOVERY_2_DESCRIPTION	Ealshay <color=yellow>6</color> ealthhay everyyay 2 econdssay.
CONDITION_RECOVERY_3_DESCRIPTION	Ealshay <color=yellow>9</color> ealthhay everyyay 2 econdssay.
CONDITION_RECOVERY_4_DESCRIPTION	Ealshay <color=yellow>12</color> ealthhay everyyay 2 econdssay.
CONDITION_RECOVERY_5_DESCRIPTION	Ealshay <color=yellow>24%</color> ofyay axmay ealthhay everyyay 2 econdssay.
CONDITION_SIPHON_LEECH_NAME	Iphonsay Eechlay
CONDITION_SIPHON_LEECH_1_DESCRIPTION	Ealsday 3 iphoningsay amageday everyyay econdsay.
CONDITION_SIPHON_LEECH_2_DESCRIPTION	Ealsday 4 iphoningsay amageday everyyay econdsay.
CONDITION_SIPHON_LEECH_3_DESCRIPTION	Ealsday 5 iphoningsay amageday everyyay econdsay.
CONDITION_STURDY_NAME	Urdystay
CONDITION_STURDY_1_DESCRIPTION	Immuneyay otay ockbackknay. Autoyay arriespay incomingyay attacksyay.
CONDITION_STURDY_2_DESCRIPTION	Immuneyay otay ockbackknay. Autoyay arriespay incomingyay attacksyay.
CONDITION_STURDY_3_DESCRIPTION	Immuneyay otay ockbackknay. Autoyay arriespay incomingyay attacksyay.
STAT_MODIFIER_DIVINE_TAG	Ivineday
STAT_MODIFIER_EARTHEN_TAG	Earthenyay
STAT_MODIFIER_ELDRITCH_TAG	Eldritchyay
STAT_MODIFIER_ENERGETIC_TAG	Energeticyay
STAT_MODIFIER_GUARDIAN_TAG	Uardiangay
STAT_MODIFIER_KILLER_TAG	Illerkay
STAT_MODIFIER_LIVELY_TAG	Ivelylay
STAT_MODIFIER_MAGICAL_TAG	Agicalmay
STAT_MODIFIER_MANAFONT_TAG	Anafontmay
STAT_MODIFIER_MOLTEN_TAG	Oltenmay
STAT_MODIFIER_PRECISE_TAG	Ecisepray
STAT_MODIFIER_TIDAL_TAG	Idaltay
RACE_IMP_NAME	Impyay
RACE_IMP_DESCRIPTION	Orsakenfay emonsday owhay omecay omfray anyay aquaticyay ealmray angledtay ithway ellishhay achinerymay. Byyay eirthay ownyay illway, ethay Impsyay ereway otnay ableyay otay inkthay oryay actyay orfay emselvesthay, ollowingfay ordersyay omfray ethay occultyay owhay oftenyay ummonedsay emthay.
RACE_IMP_MISC	Ornshay
RACE_POON_NAME	Oonpay
RACE_POON_DESCRIPTION	Anyay ancientyay utbay ivingthray aceray ofyay adsdryay owhay areyay actfultay andyay unningcay. Oonspay avehay adaptedyay eyondbay eingbay eypray omfray ethay Eepday Orestfay, ableyay otay aketay onyay anyyay oefay atthay andsstay againstyay emthay.
RACE_POON_MISC	Antlersyay
RACE_KUBOLD_NAME	Uboldkay
RACE_KUBOLD_DESCRIPTION	Eptillianray ermitshay owhay areyay aturallynay adeptyay inyay ethay useyay ofyay agicmay. Ethay Ubold'skay omelandhay esidesray ithinway ayay istantday aridyay esertday, ealedsay byyay arcaneyay energiesyay.
RACE_KUBOLD_MISC	Ornshay
RACE_BYRDLE_NAME	Ebyrdlay
RACE_BYRDLE_DESCRIPTION	Elegantyay andyay exteriousday avellerstray, andyay ikelylay otay ebay aterialisticmay. Onceyay aturedmay, Esbyrdlay areyay ornsway otay eavelay eirthay ockflay omfray eirthay ingdomkay otay indfay eirthay eternalyay estinyday.
RACE_BYRDLE_MISC	Eakbay
RACE_CHANG_NAME	Angchay
RACE_CHANG_DESCRIPTION	Ompactcay, etyay urdystay. Alwaysyay eageryay orfay adventureyay eyondbay eirthay opescay. Angschay omecay omfray ayay eriouslymystay advancedyay ivilizationcay, utbay ereway oftenyay outcastsyay andyay eensay asyay oublemakerstray.
RACE_CHANG_MISC	Iskerswhay
COMBAT_ELEMENT_AIR_NAME	Airyay
COMBAT_ELEMENT_EARTH_NAME	Earthyay
COMBAT_ELEMENT_FIRE_NAME	Irefay
COMBAT_ELEMENT_HOLY_NAME	Olyhay
COMBAT_ELEMENT_NORMAL_NAME	Ormalnay
COMBAT_ELEMENT_SHADOW_NAME	Adowshay
COMBAT_ELEMENT_WATER_NAME	Aterway
PLAYER_CLASS_EMPTY_NAME	Ovicenay
PLAYER_CLASS_FIGHTER_NAME	Ighterfay
PLAYER_CLASS_MYSTIC_NAME	Icmystay
PLAYER_CLASS_BANDIT_NAME	Anditbay
SKILL_BELL_MASTERY_NAME	Ellbay Asterymay
SKILL_BELL_MASTERY_DESCRIPTION	Earnslay ethay abilityyay otay urtherfay utilizeyay owerspay ofyay Agicmay Ellsbay, allowingyay ethay astercay otay argechay attackyay ithway emthay.
SKILL_H_MELEE_MASTERY_NAME	Hyay. Eleemay Asterymay
SKILL_H_MELEE_MASTERY_DESCRIPTION	Earnslay ethay abilityyay otay ebay oremay adeptyay ithway eavyhay eleemay eaponryway.
SKILL_KATAR_MASTERY_NAME	Atarkay Asterymay
SKILL_KATAR_MASTERY_DESCRIPTION	Earnslay ethay abilityyay otay ebay oremay adeptyay ithway Atarskay.
SKILL_MELEE_MASTERY_NAME	Eleemay Asterymay
SKILL_MELEE_MASTERY_DESCRIPTION	Earnslay ethay abilityyay otay ebay oremay adeptyay ithway eleemay eaponryway.
SKILL_POLEARM_MASTERY_NAME	Olearmpay Asterymay
SKILL_POLEARM_MASTERY_DESCRIPTION	Earnslay ethay abilityyay otay ebay oremay adeptyay ithway olearmspay.
SKILL_RANGED_MASTERY_NAME	Angedray Asterymay
SKILL_RANGED_MASTERY_DESCRIPTION	Earnslay ethay abilityyay otay ebay oremay adeptyay ithway angedray eaponryway.
SKILL_SCEPTER_MASTERY_NAME	Epterscay Asterymay
SKILL_SCEPTER_MASTERY_DESCRIPTION	Earnslay ethay abilityyay otay argechay eptersscay, unleashingyay ongerstray ojectilespray uponyay eleaseray.
SKILL_CRYO_NEEDLE_NAME	Ocryay Eedlenay
SKILL_CRYO_NEEDLE_DESCRIPTION	Astscay ayay uickqay etsay ofyay inningspay iceyay eedlesnay.
SKILL_DIVINE_NAME	Ivineday
SKILL_DIVINE_DESCRIPTION	Acesplay ayay olyhay ellway elowbay ethay astercay, amagingday argetstay andyay ealinghay alliesyay overyay imetay.
SKILL_EXECUTE_NAME	Executeyay
SKILL_EXECUTE_DESCRIPTION	Ealsday amageday otay ayay argettay, ithway ayay ancechay otay illkay emthay instantlyyay ifyay eythay areyay owlay onyay ealthhay. <color=lime>Equiresray ayay icalphysay ombatcay eaponway.</color>
SKILL_FIREBALL_NAME	Ireballfay
SKILL_FIREBALL_DESCRIPTION	Astscay anyay additionalyay ireballfay eachyay ankray.
SKILL_GEYSER_NAME	Eysergay
SKILL_GEYSER_DESCRIPTION	Astscay ayay agicalmay opletdray atthay explodesyay intoyay ayay eezingfray illarpay enwhay acedplay.
SKILL_LIFE_TAP_NAME	Ifelay Aptay
SKILL_LIFE_TAP_DESCRIPTION	Ullyfay eplenishesray ethay asterscay anamay ithway ethay ostcay ofyay eirthay ealthhay. <color=cyan>Ineffectiveyay ifyay ethay astercay oesntday avehay enoughyay ealthhay oryay ullfay anamay.</color>
SKILL_SPIRE_NAME	Irespay
SKILL_SPIRE_DESCRIPTION	Oldsmay ethay urfacesay intoyay ayay owray ofyay arpshay iresspay.
SKILL_SPREAD_SHOT_NAME	Eadspray Otshay
SKILL_SPREAD_SHOT_DESCRIPTION	Ootsshay ayay eadspray ofyay ojectilespray. <color=lime>Equiresray ayay angedray eaponway.</color>
SKILL_FLAK_NAME	Akflay
SKILL_FLAK_DESCRIPTION	Astscay ayay urryflay ofyay onestay ardsshay.
SKILL_TALUS_NAME	Alustay
SKILL_TALUS_DESCRIPTION	Ormsfay ayay argelay oulderbay atthay ashessmay intoyay ethay oundgray.
SKILL_AGILE_TECHNIQUE_NAME	Agileyay Echniquetay
SKILL_AGILE_TECHNIQUE_DESCRIPTION	Ethay Anditbay ecomesbay oremay acrobaticyay, unlockingyay ifferentday ethodsmay ofyay ovementmay.
SKILL_BOUNCE_NAME	Ouncebay
SKILL_BOUNCE_DESCRIPTION	Ungeslay ownwardsday, enthay ouncesbay ighhay upwardsyay enwhay ittinghay ethay oundgray.
SKILL_BOMB_TRAP_NAME	Ombbay Aptray
SKILL_BOMB_TRAP_DESCRIPTION	Acesplay anyay explosiveyay aptray atthay iggerstray ithinway oximitypray ofyay earbynay argetstay.
SKILL_DEVIOUS_SIGNET_NAME	Eviousday Ignetsay
SKILL_DEVIOUS_SIGNET_DESCRIPTION	Appliesyay ayay ignetsay otay ethay Anditbay andyay earbynay alliesyay, increasingyay evasionyay, axmay aminastay, andyay iticalcray ikestray anceschay.
SKILL_KILLER_JAB_NAME	Illerkay Abjay
SKILL_KILLER_JAB_DESCRIPTION	Ikesstray ethay argettay, ealingday ongstray initialyay amageday andyay ayay oisonpay ebuffday. <color=lime>Equiresray ayay icalphysay ombatcay eaponway.</color>
SKILL_MIST_VEIL_NAME	Istmay Eilvay
SKILL_MIST_VEIL_DESCRIPTION	Ethay anditbay evokesyay ayay istmay omfray eirthay odybay, anishingvay emselvesthay andyay ealinghay orfay ayay ortshay imetay.
SKILL_PAY_DAY_NAME	Aypay Ayday
SKILL_PAY_DAY_DESCRIPTION	Ethay Anditbay unsstay ethay argettay, additionallyyay ausingcay emthay otay opdray urrencycay.\n ayay icalphysay ombatcay eaponway.</color>
SKILL_VENOM_SHOT_NAME	Enomvay Otshay
SKILL_VENOM_SHOT_DESCRIPTION	Ootsshay ayay enomvay oatedcay ojectilepray. Ealsday amageday overyay imetay, andyay ecreasesday ethay arget'stay efenseday. <color=lime>Equiresray ayay angedray eaponway.</color>
SKILL_VOLLEY_NAME	Olleyvay
SKILL_VOLLEY_DESCRIPTION	<color=cyan>Argechay andyay eleaseray illskay.</color> Iresfay ayay ojectilepray inyay ethay airyay, ainingray apnelshray ithinway ayay adiusray elowbay. <color=lime>Equiresray ayay angedray eaponway.</color>
SKILL_BULWARK_NAME	Ulwarkbay
SKILL_BULWARK_DESCRIPTION	Olstersbay ethay efensiveday engthstray ofyay ethay Ighterfay.
SKILL_REFLECT_NAME	Eflectray
SKILL_REFLECT_DESCRIPTION	Allowsyay ethay Ighterfay otay eflectray eleemay amageday ifyay uccessfullysay arriedpay.
SKILL_BLOOD_GUSH_NAME	Oodblay Ushgay
SKILL_BLOOD_GUSH_DESCRIPTION	Ealsday initialyay amageday, enthay appliesyay ayay eedingblay amageday overyay imetay onditioncay onyay ithay. <color=lime>Equiresray ayay icalphysay ombatcay eaponway.</color>
SKILL_CYCLONE_NAME	Onecyclay
SKILL_CYCLONE_DESCRIPTION	Ethay Ighterfay owsthray eirthay eaponway asyay ayay oomerangbay, ausingcay ersistantpay ighhay eatthray amageday otay argetstay. <color=lime>Equiresray ayay otway andedhay icalphysay ombatcay eaponway.</color>
SKILL_LETHAL_STRIKE_NAME	Ethallay Ikestray
SKILL_LETHAL_STRIKE_DESCRIPTION	<color=cyan>Argechay andyay eleaseray illskay.</color> Endssay ethay Ighterfay intoyay ayay ashday, andinglay ayay eavyhay orcefay attackyay onyay ithay. <color=lime>Equiresray ayay icalphysay ombatcay eaponway.</color>
SKILL_RAGE_NAME	Ageray
SKILL_RAGE_DESCRIPTION	Ivesdray ethay Ighterfay andyay eirthay earbynay alliesyay intoyay ayay itfay ofyay ageray, <color=lime>increasingyay allyay owerpay atsstay emporarilytay.</color>
SKILL_SHIELD_BASH_NAME	Ieldshay Ashbay
SKILL_SHIELD_BASH_DESCRIPTION	Ethay Ighterfay ashesbay ithway eirthay ieldshay, ovidingpray ayay unstay orfay ayay ortshay eriodpay onyay ithay. <color=lime>Equiresray ayay eldhay ieldshay.</color>
SKILL_STOMP_NAME	Ompstay
SKILL_STOMP_DESCRIPTION	Ompsstay atyay ethay oundgray, amagingday earbynay enemiesyay. <color=lime>Eneratesgay ighhay eatthray.</color>
SKILL_BLINK_NAME	Inkblay
SKILL_BLINK_DESCRIPTION	Unlocksyay ethay abilityyay otay uicklyqay eleporttay omfray oneyay ointpay otay anotheryay.
SKILL_MANAFLOW_NAME	Anaflowmay
SKILL_MANAFLOW_DESCRIPTION	Ommunescay ithway ethay eylay energiesyay atthay urroundsay ethay astercay, ecievingray asterfay anamay egenerationray.
SKILL_CROSS_NAME	Osscray
SKILL_CROSS_DESCRIPTION	<color=cyan>Argechay andyay eleaseray illskay.</color> Anifestsmay ayay ourcesay ofyay arcaneyay agicmay, explodingyay andyay ockingknay oesfay ackbay.
SKILL_FLUXBOLT_NAME	Uxboltflay
SKILL_FLUXBOLT_DESCRIPTION	Astscay ayay agicmay ojectilepray atthay explodesyay onyay impactyay. Ashay otentialpay otay ithay ultiplemay imestay eachyay ankray.
SKILL_FLUXSPEAR_NAME	Uxspearflay
SKILL_FLUXSPEAR_DESCRIPTION	Astscay ayay iercingpay earspay ofyay arcaneyay agicmay inyay ontfray ofyay ethay astercay, ealingday amageday andyay unningstay allyay adjacentyay argetstay.
SKILL_IMBUE_NAME	Imbueyay
SKILL_IMBUE_DESCRIPTION	Imbuesyay ayay icalmystay iritspay otay ethay astercay andyay earbynay alliesyay, <color=cyan>increasingyay eirthay aximummay anamay andyay agicmay owerpay.</color>
SKILL_NOVA_NAME	Ovanay
SKILL_NOVA_DESCRIPTION	Areayay ofyay effectyay illskay atthay emitsyay ayay ingray ofyay agicmay energyyay aroundyay ethay astercay, ushingpay ackbay enemiesyay.
SKILL_PRISM_NAME	Ismpray
SKILL_PRISM_DESCRIPTION	Ormsfay ayay ieldshay aroundyay ethay astercay, absorbingyay anyyay incomingyay amageday.
SKILL_RESTORA_NAME	Estoraray
SKILL_RESTORA_DESCRIPTION	Estoresray earbynay alliesyay ealthhay, includingyay ethay Asterscay ealthhay.
SKILL_ALACRITY_NAME	Alacrityyay
SKILL_ALACRITY_DESCRIPTION	Appliesyay ayay earcastclay oonbay. Ethay extnay astcay illway ebay instantyay ithway onay anamay, ealthhay oryay aminastay ostcay.
SKILL_INNER_FOCUS_NAME	Inneryay Ocusfay
SKILL_INNER_FOCUS_DESCRIPTION	Ovidespray ayay uffbay atthay uaranteesgay ayay 100% Iticalcray Ikestray ancechay orfay ethay extnay attackyay.
SKILL_LEG_UP_NAME	Eglay Upyay
SKILL_LEG_UP_DESCRIPTION	Antsgray ayay ovementmay eedspay increaseyay uffbay, additionallyyay increasingyay evasionyay.
SKILL_RECALL_NAME	Ecallray
SKILL_RECALL_DESCRIPTION	Ecallsray ethay ayerplay ackbay otay Anctumsay, awningspay ayay ortalpay otay eturnray erewhay ethay astercay ecalledray omfray. <color=lime>Ancay onlyyay astcay outsideyay ofyay Anctumsay.</color>
SKILL_RECOVERY_NAME	Ecoveryray
SKILL_RECOVERY_DESCRIPTION	Appliesyay ayay ealinghay onditioncay atthay estoresray ealthhay overyay imetay.
SKILL_ROCK_TOSS_NAME	Ockray Osstay
SKILL_ROCK_TOSS_DESCRIPTION	Ossestay ayay ockray, eneratinggay ighhay eatthray onyay ithay argetstay.
SKILL_SIPHON_LEECH_NAME	Iphonsay Eechlay
SKILL_SIPHON_LEECH_DESCRIPTION	Ootsshay ayay iphoningsay ojectilepray atthay awnsspay eldritchyay eecheslay onyay ethay ithay argettay, ealinghay ethay astercay asyay eythay ealday amageday.
SKILL_STURDY_NAME	Urdystay
SKILL_STURDY_DESCRIPTION	Ovidespray ayay uffbay atthay antsgray immunityyay otay ockbackknay andyay autoyay arriespay incomingyay attacksyay.
STAT_ATTRIBUTE_STRENGTH_NAME	Engthstray
STAT_ATTRIBUTE_STRENGTH_DESCRIPTOR	Increasesyay Attackyay Owerpay andyay Axmay Aminastay.
STAT_ATTRIBUTE_MIND_NAME	Indmay
STAT_ATTRIBUTE_MIND_DESCRIPTOR	Increasesyay Agicmay Owerpay andyay Axmay Anamay.
STAT_ATTRIBUTE_DEXTERITY_NAME	Exterityday
STAT_ATTRIBUTE_DEXTERITY_DESCRIPTOR	Increasesyay Exday Owerpay, Attackyay Iticalcray %, andyay Agicmay Iticalcray %.
STAT_ATTRIBUTE_VITALITY_NAME	Italityvay
STAT_ATTRIBUTE_VITALITY_DESCRIPTOR	Increasesyay Axmay Ealthhay.
WEAPON_TYPE_UNARMED_NAME	Unarmedyay
WEAPON_TYPE_KATARS_NAME	Atarskay
WEAPON_TYPE_MELEE_NAME	Eleemay
WEAPON_TYPE_HEAVY_MELEE_NAME	Eavyhay Eleemay
WEAPON_TYPE_POLEARM_NAME	Olearmpay
WEAPON_TYPE_RANGE_WEAPON_NAME	Angeray Eaponway
WEAPON_TYPE_MAGIC_SCEPTER_NAME	Agicmay Epterscay
WEAPON_TYPE_MAGIC_BELL_NAME	Agicmay Ellbay
DIALOGDATA_ANGELA_NAME_TAG	Angelayay
DIALOGDATA_ANGELA_BRANCH_0_DIALOG_0_INPUT	Hmyay?
DIALOGDATA_ANGELA_BRANCH_0_DIALOG_0_INPUT_ALT_0	Hmyay?
DIALOGDATA_ANGELA_BRANCH_0_DIALOG_0_INPUT_ALT_1	Esyay?
DIALOGDATA_ANGELA_BRANCH_0_DIALOG_0_INPUT_ALT_2	Ohyay?
DIALOGDATA_ANGELA_BRANCH_0_DIALOG_0_SELECTION_0	Evermindnay...
DIALOGDATA_ANGELA_BRANCH_0_DIALOG_0_SELECTION_1	Iyay ouldway ikelay otay owknay...
DIALOGDATA_ANGELA_BRANCH_0_DIALOG_0_SELECTION_2	Otgay anyyay Uestsqay?
DIALOGDATA_ANGELA_BRANCH_1_DIALOG_0_INPUT	Ellway... et'slay eesay atwhay ouyay ouldcay oday, allshay eway?
DIALOGDATA_ANGELA_BRANCH_1_DIALOG_0_INPUT_ALT_0	Ellway... et'slay eesay atwhay ouyay ouldcay oday, allshay eway?
DIALOGDATA_ANGELA_BRANCH_1_DIALOG_0_INPUT_ALT_1	Hmyay, ellway... et'slay eesay...
DIALOGDATA_ANGELA_BRANCH_1_DIALOG_0_INPUT_ALT_2	Isthay orldway ouldcay useyay omesay uritypay, esyay?
DIALOGDATA_ANGELA_BRANCH_1_DIALOG_0_SELECTION_0	Eesay ayay!
DIALOGDATA_ANGELA_BRANCH_1_DIALOG_0_SELECTION_1	Oneyay otheryay ingthay...
DIALOGDATA_ANGELA_BRANCH_2_DIALOG_0_INPUT	Myyay owledgeknay isyay oursyay, atwhay ancay Iyay elphay ouyay ithway?
DIALOGDATA_ANGELA_BRANCH_2_DIALOG_0_SELECTION_0	Ellway, actuallyyay...
DIALOGDATA_ANGELA_BRANCH_2_DIALOG_0_SELECTION_1	Atwhay areyay Icsmystay?
DIALOGDATA_ANGELA_BRANCH_2_DIALOG_0_SELECTION_2	Erewhay areyay eway?
DIALOGDATA_ANGELA_BRANCH_2_DIALOG_0_SELECTION_3	Owhay areyay ouyay?
DIALOGDATA_ANGELA_BRANCH_2_DIALOG_0_SELECTION_4	Ethay Allingcay?
DIALOGDATA_ANGELA_BRANCH_3_DIALOG_0_INPUT	Eway areyay inyay Anctumsay, ethay astlay astionbay ofyay eacepay ithinway isthay aintedtay orldway...
DIALOGDATA_ANGELA_BRANCH_3_DIALOG_1_INPUT	Onay eaturecray ofyay evilyay ancay everyay enteryay asyay onglay asyay I'myay erehay. Asyay atefay ashay ityay, Iyay ustmay ebay erehay otay eepkay Anctumsay afesay.
DIALOGDATA_ANGELA_BRANCH_3_DIALOG_1_SELECTION_0	Iyay eesay. Anywaysyay...
DIALOGDATA_ANGELA_BRANCH_4_DIALOG_0_INPUT	Uiteqay uriouscay ouyay areyay, ittlelay oneyay...
DIALOGDATA_ANGELA_BRANCH_4_DIALOG_1_INPUT	Iyay amyay oneyay ofyay ethay eethray uardiansgay owhay avehay accompaniedyay isthay andlay omfray ethay eryvay eginningbay.
DIALOGDATA_ANGELA_BRANCH_4_DIALOG_2_INPUT	Iyay asway onceyay ableyay otay eesay allyay, utbay myyay agicmay ashay eenbay ifledstay byyay... unfortunateyay ircumstancescay.
DIALOGDATA_ANGELA_BRANCH_4_DIALOG_3_INPUT	Allyay Iyay ancay ustermay ownay isyay otay eepkay ethay okenbray orldway intertwinedyay, andyay otay ieldshay Anctumsay omfray arknessday.
DIALOGDATA_ANGELA_BRANCH_4_DIALOG_4_INPUT	Ithoutway myyay agicmay, ouryay oulsay ouldway ebay imprisonedyay, andyay ostlay oreverfay... uckstay ereverwhay ouyay aymay ebay.
DIALOGDATA_ANGELA_BRANCH_4_DIALOG_4_SELECTION_0	Iyay eesay, anywaysyay...
DIALOGDATA_ANGELA_BRANCH_4_DIALOG_4_SELECTION_1	At'sthay... oncerningcay.
DIALOGDATA_ANGELA_BRANCH_5_DIALOG_0_INPUT	Ou'reyay inyay oodgay andshay, ittlelay oneyay...
DIALOGDATA_ANGELA_BRANCH_5_DIALOG_1_INPUT	Avehay aithfay, erethay areyay anymay oulssay alongsideyay oursyay atthay ancay eepkay isthay andlay urepay.
DIALOGDATA_ANGELA_BRANCH_5_DIALOG_2_INPUT	Aystay eterminedday, andyay eepkay ouryay eadhay eldhay ighhay... Iyay elievebay inyay ouyay.
DIALOGDATA_ANGELA_BRANCH_6_DIALOG_0_INPUT	Ohyay? Ou'rey-yay interestedyay inyay myyay udiesstay?
DIALOGDATA_ANGELA_BRANCH_6_DIALOG_1_INPUT	Ahemyay... 
DIALOGDATA_ANGELA_BRANCH_6_DIALOG_2_INPUT	Orgivefay emay, it'syay otnay oftenyay I'myay askedyay ofyay isthay.
DIALOGDATA_ANGELA_BRANCH_6_DIALOG_3_INPUT	Oosingchay otay ebay ayay Icmystay unlocksyay ethay otentialpay ofyay ethay indmay, allowingyay ethay abilityyay otay astcay owerfulpay ellsspay.
DIALOGDATA_ANGELA_BRANCH_6_DIALOG_4_INPUT	Eythay ancay arrierbay emselvesthay omfray amageday, owthray explosiveyay oltsbay, andyay iercepay oseclay eatsthray...
DIALOGDATA_ANGELA_BRANCH_6_DIALOG_5_INPUT	Otay ummarizesay uicklyqay, ethay arcaneyay agicsmay Icsmystay useyay areyay ofyay myyay ownyay owerpay...
DIALOGDATA_ANGELA_BRANCH_6_DIALOG_6_INPUT	Uiteqay ayay itbay otay aketay inyay, ouldn'tway ouyay aysay?
DIALOGDATA_ANGELA_BRANCH_7_DIALOG_0_INPUT	Ahyay, esyay...
DIALOGDATA_ANGELA_BRANCH_7_DIALOG_1_INPUT	Ouyay areyay otnay omfray isthay orldway, ittlelay oneyay. Ouyay ereway onceyay ayay ivinglay eingbay omewheresay arfay omfray erehay.
DIALOGDATA_ANGELA_BRANCH_7_DIALOG_2_INPUT	Anythingyay ouldcay avehay appenedhay, atthay I'myay unsureyay ofyay...
DIALOGDATA_ANGELA_BRANCH_7_DIALOG_3_INPUT	Iyay alledcay ouryay oulsay, amongstyay anymay othersyay, otay ivelay onceyay oremay, andyay otay otectpray isthay orldway omfray arknessday.
DIALOGDATA_ANGELA_BRANCH_7_DIALOG_4_INPUT	Iyay illway alwaysyay ebay uresay atthay ouryay oulsay aysstay urifiedpay andyay otectedpray omfray atwhay oamsray outsideyay ofyay Anctumsay.
DIALOGDATA_ANGELA_BRANCH_7_DIALOG_4_SELECTION_0	Iyay eesay, anywaysyay...
DIALOGDATA_ANGELA_BRANCH_7_DIALOG_4_SELECTION_1	Whyyay oosechay emay?
DIALOGDATA_ANGELA_BRANCH_8_DIALOG_0_INPUT	Isthay isyay anotheryay ancechay orfay ouyay otay ivelay, isn'tyay ityay?
DIALOGDATA_ANGELA_BRANCH_8_DIALOG_1_INPUT	Iyay understandyay atthay ouyay indfay isthay oncerningcay...
DIALOGDATA_ANGELA_BRANCH_8_DIALOG_2_INPUT	Oweverhay, urgatorypay afteryay eathday ertainlycay isn'tyay ayay ooplay orthway ufferingsay. Ouryay oulsay estsray oremay inyay isthay orldway.
DIALOGDATA_ANGELA_BRANCH_8_DIALOG_3_INPUT	Atthay I'myay eryvay uresay ofyay, ittlelay oneyay...
DIALOGDATA_ANGELA_BRANCH_9_DIALOG_0_INPUT	
DIALOGDATA_ANGELA_BRANCH_9_DIALOG_0_INPUT_ALT_0	Aketay arecay, ittlelay oneyay...
DIALOGDATA_ANGELA_BRANCH_9_DIALOG_0_INPUT_ALT_1	Iyay illway ebay atchingway alongsideyay ouyay.
DIALOGDATA_ANGELA_BRANCH_9_DIALOG_0_INPUT_ALT_2	Arewellfay, ittlelay oneyay.
DIALOGDATA_ANGELA_BRANCH_9_DIALOG_0_INPUT_ALT_3	Aystay afesay...
DIALOGDATA_ANGELA_INTRODUCTION_BRANCH_0_DIALOG_0_INPUT	
DIALOGDATA_ANGELA_INTRODUCTION_BRANCH_0_DIALOG_0_INPUT_ALT_0	Oodnessgay!
DIALOGDATA_ANGELA_INTRODUCTION_BRANCH_0_DIALOG_0_INPUT_ALT_1	Ahyay!
DIALOGDATA_ANGELA_INTRODUCTION_BRANCH_0_DIALOG_0_INPUT_ALT_2	Ohyay myyay!
DIALOGDATA_ANGELA_INTRODUCTION_BRANCH_0_DIALOG_1_INPUT	Atwhay ayay eliefray otay eesay atthay myyay allingcay orkedway... Iyay asway almostyay ertaincay ouryay oulsay ould'veway eenbay ostlay.
DIALOGDATA_ANGELA_INTRODUCTION_BRANCH_0_DIALOG_2_INPUT	Iyay amyay Angelayay Uxflay, Icmystay Uardiangay ofyay Anctumsay.
DIALOGDATA_ANGELA_INTRODUCTION_BRANCH_0_DIALOG_3_INPUT	Iyay understandyay atthay ouyay aymay avehay ayay ewfay uestionsqay otay askyay...
DIALOGDATA_ANGELA_INTRODUCTION_BRANCH_0_DIALOG_4_INPUT	Utbay irstfay, et'slay etgay ouryay earingsbay ortedsay outyay, esyay?
DIALOGDATA_ANGELA_INTRODUCTION_BRANCH_0_DIALOG_4_SELECTION_0	Eesay ayay!
DIALOGDATA_ENOK_NAME_TAG	Enokyay
DIALOGDATA_ENOK_BRANCH_0_DIALOG_0_INPUT	
DIALOGDATA_ENOK_BRANCH_0_DIALOG_0_INPUT_ALT_0	Atestay ouryay usinessbay, uicklyqay.
DIALOGDATA_ENOK_BRANCH_0_DIALOG_0_INPUT_ALT_1	Erethay isyay uchmay orkway otay oday.
DIALOGDATA_ENOK_BRANCH_0_DIALOG_0_INPUT_ALT_2	Eakspay.
DIALOGDATA_ENOK_BRANCH_0_DIALOG_0_SELECTION_0	Evermindnay.
DIALOGDATA_ENOK_BRANCH_0_DIALOG_0_SELECTION_1	Iyay ouldway ikelay otay owknay...
DIALOGDATA_ENOK_BRANCH_0_DIALOG_0_SELECTION_2	Otgay Uestsqay?
DIALOGDATA_ENOK_BRANCH_1_DIALOG_0_INPUT	
DIALOGDATA_ENOK_BRANCH_1_DIALOG_0_INPUT_ALT_0	Esyay?
DIALOGDATA_ENOK_BRANCH_1_DIALOG_0_INPUT_ALT_1	Iyay avehay anyay answeryay.
DIALOGDATA_ENOK_BRANCH_1_DIALOG_0_INPUT_ALT_2	Onay uestionqay isyay eftlay unansweredyay.
DIALOGDATA_ENOK_BRANCH_1_DIALOG_0_INPUT_ALT_3	Et'slay earhay ityay.
DIALOGDATA_ENOK_BRANCH_1_DIALOG_0_SELECTION_0	Actuallyyay...
DIALOGDATA_ENOK_BRANCH_1_DIALOG_0_SELECTION_1	Owhay areyay ouyay?
DIALOGDATA_ENOK_BRANCH_1_DIALOG_0_SELECTION_2	Atwhay isyay ayay Ighterfay?
DIALOGDATA_ENOK_BRANCH_1_DIALOG_0_SELECTION_3	Arryingpay?
DIALOGDATA_ENOK_BRANCH_2_DIALOG_0_INPUT	Iyay amyay Enokyay, ethay Ighterfay Uardiangay. Iyay amyay ethay erocityfay ofyay ethay ightlay, upbringeryay ofyay ellhay againstyay arknessday.
DIALOGDATA_ENOK_BRANCH_2_DIALOG_1_INPUT	Iyay aketay ityay ouyay areyay ewnay otay isthay orldway. Ou'veyay arrivedyay atelay, uringday ayay imetay erewhay ityay andsstay orruptedcay.
DIALOGDATA_ENOK_BRANCH_2_DIALOG_2_INPUT	Myyay owerspay ovidepray ethay engthstray andyay italityvay otay ethay oulssay owhay areyay ivendray otay ovepray emselvesthay orthyway.
DIALOGDATA_ENOK_BRANCH_2_DIALOG_3_INPUT	Iyay ensesay ayay arkspay ofyay eterminationday ithinway ouyay. Uccumbsay otay earfay, andyay ouyay illway ailfay.
DIALOGDATA_ENOK_BRANCH_2_DIALOG_3_SELECTION_0	Oodbyegay.
DIALOGDATA_ENOK_BRANCH_2_DIALOG_3_SELECTION_1	Anotheryay ingthay...
DIALOGDATA_ENOK_BRANCH_3_DIALOG_0_INPUT	Ayay ostlay oulsay ancay ebay ivendray otay ethay erocityfay ofyay ayay Ighterfay onceyay eythay avehay ovenpray otay ebay ongstray enoughyay.
DIALOGDATA_ENOK_BRANCH_3_DIALOG_1_INPUT	Ayay Ighterfay ancay endray ethay eshflay ofyay oesfay, eakeningway emthay ithway oodshedblay.
DIALOGDATA_ENOK_BRANCH_3_DIALOG_2_INPUT	Ayay Ighterfay ancay evastateday urroundingsay enemiesyay, omfray ayay oseclay ompstay, oryay afaryay ithway ayay ethallay ikestray.
DIALOGDATA_ENOK_BRANCH_3_DIALOG_3_INPUT	Ityay akestay upremesay ocusfay otay avehay atwhay ityay akestay otay astermay ethay artyay ofyay ombatcay.
DIALOGDATA_ENOK_BRANCH_3_DIALOG_4_INPUT	Ifyay ouyay avehay atwhay ityay akestay, eturnray otay emay, andyay Iyay ancay eachtay ouyay.
DIALOGDATA_ENOK_BRANCH_3_DIALOG_4_SELECTION_0	Oodbyegay.
DIALOGDATA_ENOK_BRANCH_3_DIALOG_4_SELECTION_1	Iyay eesay, anywaysyay...
DIALOGDATA_ENOK_BRANCH_4_DIALOG_0_INPUT	
DIALOGDATA_ENOK_BRANCH_4_DIALOG_0_INPUT_ALT_0	Erethay isyay usinessbay atthay ustmay ebay endedtay otay.
DIALOGDATA_ENOK_BRANCH_4_DIALOG_0_INPUT_ALT_1	Et'slay eesay ifyay ou'reyay upyay otay ethay asktay.
DIALOGDATA_ENOK_BRANCH_4_DIALOG_0_INPUT_ALT_2	Odaytay isyay ayay inefay ayday orfay oodshedblay.
DIALOGDATA_ENOK_BRANCH_4_DIALOG_0_INPUT_ALT_3	It'syay imetay otay athergay ouryay engthstray.
DIALOGDATA_ENOK_BRANCH_4_DIALOG_0_SELECTION_0	Eesay ayay!
DIALOGDATA_ENOK_BRANCH_4_DIALOG_0_SELECTION_1	Omethingsay elseyay...
DIALOGDATA_ENOK_BRANCH_5_DIALOG_0_INPUT	Arryingpay ouryay oesfay isyay essentialyay inyay eleemay ombatcay.
DIALOGDATA_ENOK_BRANCH_5_DIALOG_1_INPUT	Otay arrypay emthay, ockblay ortlyshay eforebay eythay initiateyay eirthay attackyay.
DIALOGDATA_ENOK_BRANCH_5_DIALOG_2_INPUT	Ifyay ouyay uccessfullysay arrypay emthay, ityay illway otnay ostcay anyyay ofyay ouryay aminastay.
DIALOGDATA_ENOK_BRANCH_5_DIALOG_3_INPUT	Oweverhay, ouryay oesfay ustmay ebay elativelyray asyay ongstray asyay ouyay orfay isthay otay aketay inyay effectyay.
DIALOGDATA_ENOK_BRANCH_5_DIALOG_4_INPUT	Ifyay ouyay ereway otay ightfay ouryay oefay andyay eythay appenhay otay ebay uchmay ongerstray anthay ouyay,
DIALOGDATA_ENOK_BRANCH_5_DIALOG_5_INPUT	ouyay illway alterfay andyay ooselay ouryay aminastay uicklyqay.
DIALOGDATA_ENOK_BRANCH_5_DIALOG_6_INPUT	Atchway ouryay enemiesyay oselyclay. Eythay areyay othingnay otay ouyay ifyay ouyay ategizestray.
DIALOGDATA_ENOK_BRANCH_5_DIALOG_6_SELECTION_0	Eesay ayay!
DIALOGDATA_ENOK_BRANCH_5_DIALOG_6_SELECTION_1	Omethingsay elseyay...
DIALOGDATA_ENOK_INTRODUCTION_BRANCH_0_DIALOG_0_INPUT	Ookslay ikelay eway avehay eshfray oodblay.
DIALOGDATA_ENOK_INTRODUCTION_BRANCH_0_DIALOG_1_INPUT	Ifyay ouyay eeksay otay oughentay ourselfyay andyay indfay ethay aysway ofyay alorvay, eakspay otay emay.
DIALOGDATA_ENOK_INTRODUCTION_BRANCH_0_DIALOG_2_INPUT	Ifyay ouyay avehay anythingyay otay aysay, ityay isyay estbay ouyay oday osay ownay.
DIALOGDATA_ENOK_INTRODUCTION_BRANCH_0_DIALOG_2_SELECTION_0	Evermindnay.
DIALOGDATA_ENOK_INTRODUCTION_BRANCH_0_DIALOG_2_SELECTION_1	Iyay ouldway ikelay otay owknay...
DIALOGDATA_ENOK_INTRODUCTION_BRANCH_0_DIALOG_2_SELECTION_2	Otgay Uestsqay?
DIALOGDATA_SANCTUMCIVILIAN_00_NAME_TAG	
DIALOGDATA_SANCTUMCIVILIAN_00_BRANCH_0_DIALOG_0_INPUT	
DIALOGDATA_SANCTUMCIVILIAN_00_BRANCH_0_DIALOG_0_INPUT_ALT_0	Ellohay.
DIALOGDATA_SANCTUMCIVILIAN_00_BRANCH_0_DIALOG_0_INPUT_ALT_1	Iyay inkthay i'veyay eensay ouryay acefay eforebay... oryay aybemay otnay.
DIALOGDATA_SANCTUMCIVILIAN_00_BRANCH_0_DIALOG_0_INPUT_ALT_2	Ankthay oodnessgay Anctumsay isyay afesay.
DIALOGDATA_SANCTUMCIVILIAN_00_INTRODUCTION_BRANCH_0_DIALOG_0_INPUT	
DIALOGDATA_SANCTUMCIVILIAN_00_INTRODUCTION_BRANCH_0_DIALOG_0_INPUT_ALT_0	Ellohay.
DIALOGDATA_SALLY_NAME_TAG	Allysay
DIALOGDATA_SALLY_BRANCH_0_DIALOG_0_INPUT	Ellway I'llyay ebay! Aintyay' ityay ayay easureplay otay eesay ayay!
DIALOGDATA_SALLY_BRANCH_0_DIALOG_0_INPUT_ALT_0	Ellway I'llyay ebay! Aintyay' ityay ayay easureplay otay eesay ayay!
DIALOGDATA_SALLY_BRANCH_0_DIALOG_0_INPUT_ALT_1	Owdyhay! Owhay ancay Iyay elphay ayay?
DIALOGDATA_SALLY_BRANCH_0_DIALOG_0_INPUT_ALT_2	Atwhay ancay Iyay oday ayay orfay?
DIALOGDATA_SALLY_BRANCH_0_DIALOG_0_SELECTION_0	Evermindnay...
DIALOGDATA_SALLY_BRANCH_0_DIALOG_0_SELECTION_1	At'swhay ethay eaturecray?
DIALOGDATA_SALLY_BRANCH_0_DIALOG_0_SELECTION_2	Otgay Uestsqay?
DIALOGDATA_SALLY_BRANCH_0_DIALOG_0_SELECTION_3	Iyay antway otay adetray!
DIALOGDATA_SALLY_BRANCH_1_DIALOG_0_INPUT	Ohyay esyay, whyyay ofyay oursecay! At'llwhay ebay orfay ethay ourneyjay? Uyingbay, ellingsay?
DIALOGDATA_SALLY_BRANCH_1_DIALOG_0_INPUT_ALT_0	Ohyay esyay, whyyay ofyay oursecay! At'llwhay ebay orfay ethay ourneyjay? Uyingbay, ellingsay?
DIALOGDATA_SALLY_BRANCH_1_DIALOG_0_INPUT_ALT_1	I'veyay otgay ethay oodsgay ayay eednay!
DIALOGDATA_SALLY_BRANCH_1_DIALOG_0_INPUT_ALT_2	Evernay ayay ullday ayday orfay usinessbay!
DIALOGDATA_SALLY_BRANCH_1_DIALOG_0_INPUT_ALT_3	Ohyay? Otgay omethinsay' inyshay orfay emay?
DIALOGDATA_SALLY_BRANCH_1_DIALOG_0_SELECTION_0	Oodbyegay!
DIALOGDATA_SALLY_BRANCH_1_DIALOG_0_SELECTION_1	Otgay Uestsqay?
DIALOGDATA_SALLY_BRANCH_2_DIALOG_0_INPUT	Ifyay ayay otgay omethinsay' otay adetray, opstay byyay againyay!
DIALOGDATA_SALLY_BRANCH_2_DIALOG_0_INPUT_ALT_0	Ifyay ayay otgay omethinsay' otay adetray, opstay byyay againyay!
DIALOGDATA_SALLY_BRANCH_2_DIALOG_0_INPUT_ALT_1	Alwaysyay ayay easureplay! 
DIALOGDATA_SALLY_BRANCH_2_DIALOG_0_INPUT_ALT_2	Aketay arecay, unhay!
DIALOGDATA_SALLY_BRANCH_2_DIALOG_0_INPUT_ALT_3	I'llyay ebay erehay omfray uskday illtay' awnday!
DIALOGDATA_SALLY_BRANCH_2_DIALOG_0_INPUT_ALT_4	Aystay afesay, ayay earhay?
DIALOGDATA_SALLY_BRANCH_3_DIALOG_0_INPUT	Whyyay, at'sthay myyay etpay imicmay, Ikespay! Ehay on'tway itebay.
DIALOGDATA_SALLY_BRANCH_3_DIALOG_1_INPUT	E'shay uiteqay iendlyfray, oughthay ayay ainpay inyay ethay ecknay! It'dyay evernay ebay ethay amesay ithoutway emyay'.
DIALOGDATA_SALLY_BRANCH_3_DIALOG_2_INPUT	Owy'knay, Ikespay ancay oldhay ontoyay ouryay itemsyay ifyay ou'reyay overburdenedyay. Ain'tyay atthay omethingsay?
DIALOGDATA_SALLY_BRANCH_4_DIALOG_0_INPUT	
DIALOGDATA_SALLY_BRANCH_4_DIALOG_0_INPUT_ALT_0	Atters'may ofyay actfay, aybemay Iyay oday!
DIALOGDATA_SALLY_BRANCH_4_DIALOG_0_INPUT_ALT_1	Iyay inkthay Iyay otgay omethinsay' orfay ayay!
DIALOGDATA_SALLY_BRANCH_4_DIALOG_0_INPUT_ALT_2	Ere'sthay omesay ingsthay otay aketay arecay ofyay!
DIALOGDATA_SALLY_BRANCH_4_DIALOG_0_SELECTION_0	Oodbyegay.
DIALOGDATA_SALLY_BRANCH_4_DIALOG_0_SELECTION_1	Et'slay adetray!
DIALOGDATA_SALLY_INTRODUCTION_BRANCH_0_DIALOG_0_INPUT	
DIALOGDATA_SALLY_INTRODUCTION_BRANCH_0_DIALOG_0_INPUT_ALT_0	Ellway, ellway! It'syay icenay otay eesay ayay ewnay acefay aroundyay esethay artspay!
DIALOGDATA_SALLY_INTRODUCTION_BRANCH_0_DIALOG_0_INPUT_ALT_1	Owdyhay! On'tday inkthay I'veyay eensay ayay aroundyay erehay.
DIALOGDATA_SALLY_INTRODUCTION_BRANCH_0_DIALOG_0_INPUT_ALT_2	Eyhay erethay unhay, omecay onyay inyay!
DIALOGDATA_SALLY_INTRODUCTION_BRANCH_0_DIALOG_0_INPUT_ALT_3	Oodgay otay eesay omeonesay ewnay opstay byyay!
DIALOGDATA_SALLY_INTRODUCTION_BRANCH_0_DIALOG_1_INPUT	I'myay Allysay! Elcomeway otay myyay Orestay!
DIALOGDATA_SALLY_INTRODUCTION_BRANCH_0_DIALOG_2_INPUT	I'veyay otgay ayay ewfay oodsgay erehay andyay erethay otay ellsay, utbay I'myay alsoyay uyinbay'! Ifyay ayay indfay anythingyay inyshay, ingbray ityay onyay overyay!
DIALOGDATA_SALLY_INTRODUCTION_BRANCH_0_DIALOG_3_INPUT	Anymay ofyay myyay olleaguescay areyay atteredscay aboutyay acrossyay ethay andlay ootay! Elltay emyay' Iyay entsay ayay ifyay ouyay eetmay emyay'.
DIALOGDATA_SALLY_INTRODUCTION_BRANCH_0_DIALOG_4_INPUT	Emmelay owknay ifyay Iyay ancay oday anythinyay' orfay ayay!
DIALOGDATA_SALLY_INTRODUCTION_BRANCH_0_DIALOG_4_SELECTION_0	Otednay, anksthay!
DIALOGDATA_SALLY_INTRODUCTION_BRANCH_0_DIALOG_4_SELECTION_1	Otgay Uestsqay?
DIALOGDATA_SALLY_INTRODUCTION_BRANCH_0_DIALOG_4_SELECTION_2	I'llyay eesay atwhay ouyay otgay.
DIALOGDATA_SALLY_INTRODUCTION_BRANCH_1_DIALOG_0_INPUT	Uresay ingthay, unhay!
DIALOGDATA_CRAIG_NAME_TAG	Aigcray
DIALOGDATA_CRAIG_BRANCH_0_DIALOG_0_INPUT	Ellohay myyay iendfray. Antway otay adetray?
DIALOGDATA_CRAIG_BRANCH_0_DIALOG_0_SELECTION_0	Eesay ayay.
DIALOGDATA_CRAIG_BRANCH_0_DIALOG_0_SELECTION_1	Et'slay adetray!
DIALOGDATA_CRAIG_BRANCH_1_DIALOG_0_INPUT	Okayyay, at'swhay onyay ethay enumay?
DIALOGDATA_CRAIG_BRANCH_1_DIALOG_0_SELECTION_0	Eesay ayay!
DIALOGDATA_CRAIG_INTRODUCTION_BRANCH_0_DIALOG_0_INPUT	Ellohay myyay iendfray...
DIALOGDATA_CRAIG_INTRODUCTION_BRANCH_0_DIALOG_1_INPUT	Interestedyay inyay adingtray? (Opefullyhay ouyay otgay omethingsay edibleyay, I'myay arvingstay...)
DIALOGDATA_CRAIG_INTRODUCTION_BRANCH_0_DIALOG_1_SELECTION_0	Omesay otheryay imetay.
DIALOGDATA_CRAIG_INTRODUCTION_BRANCH_0_DIALOG_1_SELECTION_1	Uresay, et'slay adetray.
DIALOGDATA_FRANKIE_NAME_TAG	Ankiefray
DIALOGDATA_FRANKIE_BRANCH_0_DIALOG_0_INPUT	Ookinlay' otay uybay omethinsay'?
DIALOGDATA_FRANKIE_BRANCH_0_DIALOG_0_SELECTION_0	Otnay ownay.
DIALOGDATA_FRANKIE_BRANCH_0_DIALOG_0_SELECTION_1	Isn'tyay ityay angerousday?
DIALOGDATA_FRANKIE_BRANCH_0_DIALOG_0_SELECTION_2	Alrightyay, I'llyay uybay.
DIALOGDATA_FRANKIE_BRANCH_1_DIALOG_0_INPUT	
DIALOGDATA_FRANKIE_BRANCH_1_DIALOG_0_INPUT_ALT_0	Iyay otgay omesay illskay ollsscray otay ellsay!
DIALOGDATA_FRANKIE_BRANCH_1_DIALOG_0_INPUT_ALT_1	Interestedyay inyay ayay Ekboarmay eadhay?
DIALOGDATA_FRANKIE_BRANCH_1_DIALOG_0_INPUT_ALT_2	Otgay omesay Unjarsbay, Agiclovesmay...
DIALOGDATA_FRANKIE_BRANCH_1_DIALOG_0_SELECTION_0	Eeyasay!
DIALOGDATA_FRANKIE_BRANCH_2_DIALOG_0_INPUT	Ehhay, unnyfay ou'dyay askyay emay atthay...
DIALOGDATA_FRANKIE_BRANCH_2_DIALOG_1_INPUT	Onay eednay otay orryway. Emthay oarsbay aren'tyay allyay atthay enacingmay otay emay.
DIALOGDATA_FRANKIE_BRANCH_2_DIALOG_2_INPUT	Oughthay... ethay onesyay inyay ethay empletay aheadyay eemsay ayay illay' aryscay. Ere'sthay omesay easuretray inyay erethay otay ootlay, owy'knay...
DIALOGDATA_FRANKIE_BRANCH_2_DIALOG_3_INPUT	Ifyay Iyay ouldcay indfay omesay ayway otay etgay inyay ithoutway ettingay' urderedmay, I'dyay ebay akinmay' omesay oodgay usinessbay.
DIALOGDATA_FRANKIE_BRANCH_2_DIALOG_4_INPUT	Arefulcay ifyay ayay everyay onsidercay oinggay inyay erethay.
DIALOGDATA_FRANKIE_INTRODUCTION_BRANCH_0_DIALOG_0_INPUT	Eyahay, avelertray! I'myay Ankiefray.
DIALOGDATA_FRANKIE_INTRODUCTION_BRANCH_0_DIALOG_1_INPUT	I'veyay otgay omesay interestinyay' oodsgay orfay ayay. Igurefay otay eckchay emthay outyay?
DIALOGDATA_FRANKIE_INTRODUCTION_BRANCH_0_DIALOG_1_SELECTION_0	Anotheryay imetay...
DIALOGDATA_FRANKIE_INTRODUCTION_BRANCH_0_DIALOG_1_SELECTION_1	Isn'tyay ityay angerousday?
DIALOGDATA_FRANKIE_INTRODUCTION_BRANCH_0_DIALOG_1_SELECTION_2	Uresay, I'llyay uybay.
DIALOGDATA_SKRIT_NAME_TAG	Itskray
DIALOGDATA_SKRIT_BRANCH_0_DIALOG_0_INPUT	
DIALOGDATA_SKRIT_BRANCH_0_DIALOG_0_INPUT_ALT_0	It'sskray otgay ayay ewfay oodgay iniesshay inyay orestay...
DIALOGDATA_SKRIT_BRANCH_0_DIALOG_0_INPUT_ALT_1	Itskray inksthay ayay eelinfay' uckylay...
DIALOGDATA_SKRIT_BRANCH_0_DIALOG_0_INPUT_ALT_2	Et'slay ilttay ethay alesscay...
DIALOGDATA_SKRIT_BRANCH_0_DIALOG_0_INPUT_ALT_3	Ehhay, ayay eadyray otay amblegay?
DIALOGDATA_SKRIT_BRANCH_0_DIALOG_0_SELECTION_0	Aybemay aterlay.
DIALOGDATA_SKRIT_BRANCH_0_DIALOG_0_SELECTION_1	Amblinggay?
DIALOGDATA_SKRIT_BRANCH_0_DIALOG_0_SELECTION_2	Alrightyay, et'slay oday ityay.
DIALOGDATA_SKRIT_BRANCH_1_DIALOG_0_INPUT	
DIALOGDATA_SKRIT_BRANCH_1_DIALOG_0_INPUT_ALT_0	Ehehhay... It'sskray otgay ethay oodsgay.
DIALOGDATA_SKRIT_BRANCH_1_DIALOG_0_INPUT_ALT_1	Itskray ikeslay ayay oicechay! Chk'Chk'Chkyay...
DIALOGDATA_SKRIT_BRANCH_1_DIALOG_0_INPUT_ALT_2	Et'slay eesay erewhay ethay allbay opsdray...
DIALOGDATA_SKRIT_BRANCH_1_DIALOG_0_INPUT_ALT_3	Anymay oodgay iniesshay erehay...
DIALOGDATA_SKRIT_BRANCH_1_DIALOG_0_SELECTION_0	I'myay oneday...
DIALOGDATA_SKRIT_BRANCH_2_DIALOG_0_INPUT	Ehhyay? Erhapspay Itskray idn'tday ealizeray otay elltay ayay.
DIALOGDATA_SKRIT_BRANCH_2_DIALOG_1_INPUT	Ivegay omesay oincay otay Itskray, andyay ayay aymay etgay omethinsay' oodgay inyay eturnray...
DIALOGDATA_SKRIT_BRANCH_2_DIALOG_2_INPUT	It'syay onenay ofyay ayay usinessbay erewhay Itskray etsgay ethay oodsgay oughthay! Eepkay ityay uietqay!
DIALOGDATA_SKRIT_BRANCH_2_DIALOG_3_INPUT	Ayay ancay e-rollray ethay ockstay Itskray offersyay asyay ellway, onay argechay! Ayay ustjay an'tcay eesay ityay illtay' ayay uybay ityay.
DIALOGDATA_SKRIT_BRANCH_2_DIALOG_4_INPUT	Itskray ervessay etterbay ockstay enwhay ayay etgay ongerstray inyay ayay ourneyjay. Eepkay atthay inyay indmay.
DIALOGDATA_SKRIT_BRANCH_2_DIALOG_4_SELECTION_0	Alrightyay, eeyasay.
DIALOGDATA_SKRIT_BRANCH_2_DIALOG_4_SELECTION_1	I'llyay ayplay.
DIALOGDATA_SKRIT_INTRODUCTION_BRANCH_0_DIALOG_0_INPUT	
DIALOGDATA_SKRIT_INTRODUCTION_BRANCH_0_DIALOG_0_INPUT_ALT_0	Ehhay, atwhay avehay eway erehay?
DIALOGDATA_SKRIT_INTRODUCTION_BRANCH_0_DIALOG_0_INPUT_ALT_1	Ayay otentialpay ustomercay, Itskray eessay?
DIALOGDATA_SKRIT_INTRODUCTION_BRANCH_0_DIALOG_0_INPUT_ALT_2	Ahhyay... esyay esyay esyay, Itskray elcomesway ayay...
DIALOGDATA_SKRIT_INTRODUCTION_BRANCH_0_DIALOG_1_INPUT	Inkinthay' ayay otgay omesay ucklay? Ingsthay otnay oinggay ethay ayway ayay antway?
DIALOGDATA_SKRIT_INTRODUCTION_BRANCH_0_DIALOG_2_INPUT	Itskray elcomesway omesay oincay otay ivegay ayay otentialpay advantageyay otay ayay ourneyjay...
DIALOGDATA_SKRIT_INTRODUCTION_BRANCH_0_DIALOG_3_INPUT	Itskray owsknay ishay airfay areshay ofyay adbay ucklay, utbay oincay alwaysyay alkstay. Ethay inyshay iltstay ethay alescay.
DIALOGDATA_SKRIT_INTRODUCTION_BRANCH_0_DIALOG_4_INPUT	Ifyay ayay otgay omesay otay owthray inyay, eakspay otay Itskray, ehehhay...
DIALOGDATA_SKRIT_INTRODUCTION_BRANCH_0_DIALOG_4_SELECTION_0	Ahnay, eeyasay.
DIALOGDATA_SKRIT_INTRODUCTION_BRANCH_0_DIALOG_4_SELECTION_1	I'llyay oday ityay.
DIALOGDATA_SPIKE_NAME_TAG	Ikespay
DIALOGDATA_SPIKE_BRANCH_0_DIALOG_0_INPUT	
DIALOGDATA_SPIKE_BRANCH_0_DIALOG_0_INPUT_ALT_0	Arkbay Arkbay! (Itemsyay, Itemsyay!!)
DIALOGDATA_SPIKE_BRANCH_0_DIALOG_0_INPUT_ALT_1	Ooray, Ooray, Ooray! (Aboutyay imetay! Ere'swhay ethay oodsgay?)
DIALOGDATA_SPIKE_BRANCH_0_DIALOG_0_INPUT_ALT_2	Oohray, Arkbay!! (Otgay emay anythingyay?)
DIALOGDATA_SPIKE_BRANCH_0_DIALOG_0_SELECTION_0	Evermindnay...
DIALOGDATA_SPIKE_BRANCH_0_DIALOG_0_SELECTION_1	Openyay Oragestay
DIALOGDATA_SPIKE_BRANCH_1_DIALOG_0_INPUT	Ohray? (At'chawhay otgay orfay emay?)
DIALOGDATA_SPIKE_BRANCH_1_DIALOG_0_SELECTION_0	Eeyasay!
DIALOGDATA_SPIKE_BRANCH_2_DIALOG_0_INPUT	Grrryay... (At'sthay ityay?)
DIALOGDATA_SPIKE_INTRODUCTION_BRANCH_0_DIALOG_0_INPUT	Arkbay Arkbay! (Itemsyay, Itemsyay!!)
DIALOGDATA_SPIKE_INTRODUCTION_BRANCH_0_DIALOG_0_SELECTION_0	Evermindnay...
DIALOGDATA_SPIKE_INTRODUCTION_BRANCH_1_DIALOG_0_INPUT	Grrryay... (At'sthay ityay?)
DIALOGDATA_VANITYMIRROR_NAME_TAG	Irrormay ofyay Illusionyay
DIALOGDATA_VANITYMIRROR_BRANCH_0_DIALOG_0_INPUT	
DIALOGDATA_VANITYMIRROR_BRANCH_0_DIALOG_0_INPUT_ALT_0	Ahyay, esyay. Avehay ouyay ungspray inspirationyay orfay ayay ewnay ooklay?
DIALOGDATA_VANITYMIRROR_BRANCH_0_DIALOG_0_INPUT_ALT_1	Ouyay eemsay inspiredyay...
DIALOGDATA_VANITYMIRROR_BRANCH_0_DIALOG_0_INPUT_ALT_2	Areyay ouyay eadyray otay aketay onyay ayay ewnay ooklay?
DIALOGDATA_VANITYMIRROR_BRANCH_0_DIALOG_0_SELECTION_0	Oodbyegay.
DIALOGDATA_VANITYMIRROR_BRANCH_0_DIALOG_0_SELECTION_1	Illusionyay Onesstay?
DIALOGDATA_VANITYMIRROR_BRANCH_0_DIALOG_0_SELECTION_2	Equipmentyay Anityvay?
DIALOGDATA_VANITYMIRROR_BRANCH_0_DIALOG_0_SELECTION_3	Eerpay intoyay ethay Irrormay.
DIALOGDATA_VANITYMIRROR_BRANCH_1_DIALOG_0_INPUT	
DIALOGDATA_VANITYMIRROR_BRANCH_1_DIALOG_0_INPUT_ALT_0	Allshay eway eginbay?
DIALOGDATA_VANITYMIRROR_BRANCH_1_DIALOG_0_INPUT_ALT_1	Atwhay isyay ouryay isionvay?
DIALOGDATA_VANITYMIRROR_BRANCH_1_DIALOG_0_INPUT_ALT_2	Atwhay isyay ethay ooklay atthay ouyay eeksay?
DIALOGDATA_VANITYMIRROR_BRANCH_1_DIALOG_0_INPUT_ALT_3	Etlay usyay ommencecay.
DIALOGDATA_VANITYMIRROR_BRANCH_1_DIALOG_0_SELECTION_0	Oodbyegay.
DIALOGDATA_VANITYMIRROR_BRANCH_2_DIALOG_0_INPUT	Illusionyay Onesstay areyay ethay ainmay ourcesay ofyay myyay owerpay, oryay atherray, myyay ervicesay.
DIALOGDATA_VANITYMIRROR_BRANCH_2_DIALOG_1_INPUT	Ilewhay otnay ecessarilynay ayay urrencycay, eythay areyay onsideredcay asyay ayay Adetray Itemyay.
DIALOGDATA_VANITYMIRROR_BRANCH_2_DIALOG_2_INPUT	Illusionyay Onesstay ancay ebay urchasedpay orfay ayay ighhay aluevay, oryay ebay oundfay omfray ethay outsideyay orldway.
DIALOGDATA_VANITYMIRROR_BRANCH_2_DIALOG_3_INPUT	Eachyay ategorycay ouyay angechay ouryay appearanceyay inyay (Olorcay, Eadhay, Odybay), illway ostcay oneyay Illusionyay Onestay eachyay.
DIALOGDATA_VANITYMIRROR_BRANCH_2_DIALOG_3_SELECTION_0	Iyay eesay, anywaysyay...
DIALOGDATA_VANITYMIRROR_BRANCH_3_DIALOG_0_INPUT	Myyay ervicessay areyay otnay eedednay otay applyyay anityvay otay ouryay eargay.
DIALOGDATA_VANITYMIRROR_BRANCH_3_DIALOG_1_INPUT	Oweverhay, ouyay illway eednay Illusionyay Onesstay otay oday isthay asktay.
DIALOGDATA_VANITYMIRROR_BRANCH_3_DIALOG_2_INPUT	Eeksay ouryay inventoryyay enumay, andyay esspray ethay anityvay uttonbay onyay ethay optay ightray ornercay ofyay ethay Abtay Enumay otay accessyay ouryay anityvay otsslay.
DIALOGDATA_VANITYMIRROR_BRANCH_3_DIALOG_3_INPUT	Allyay utbay eaponsway andyay ingsray ancay ebay anitizedvay.
DIALOGDATA_VANITYMIRROR_BRANCH_3_DIALOG_4_INPUT	Ethay equipmentyay otslay ouyay ishway otay anitizevay ustmay avehay omethingsay equippedyay otay overrideyay ethay ooklay.
DIALOGDATA_VANITYMIRROR_BRANCH_3_DIALOG_5_INPUT	Ouyay illway otnay ebay ableyay otay ansmogrifytray equipmentyay atthay isyay igherhay evellay anthay ouyay, osay eepkay atthay inyay indmay.
DIALOGDATA_VANITYMIRROR_BRANCH_3_DIALOG_6_INPUT	Iyay aketay ityay ouyay avehay anymay ideasyay ithway isthay ewnay oundfay owledgeknay, esyay?
DIALOGDATA_VANITYMIRROR_INTRODUCTION_BRANCH_0_DIALOG_0_INPUT	Eetingsgray. Iyay aketay ityay ouyay aymay avehay omesay interestyay inyay emay?
DIALOGDATA_VANITYMIRROR_INTRODUCTION_BRANCH_0_DIALOG_1_INPUT	Iyay amyay ethay Irrormay ofyay Illusionyay, Angela'syay onstructcay. Myyay oicevay ancay onlyyay ebay eardhay etweenbay elfmysay andyay ethay oneyay owhay ooseschay otay eakspay otay emay.
DIALOGDATA_VANITYMIRROR_INTRODUCTION_BRANCH_0_DIALOG_2_INPUT	Ingbray emay Illusionyay Onesstay, andyay Iyay ancay angechay ouryay ooklay ermanentlypay. Oughthay, eepkay inyay indmay atthay ouyay annotcay ebay inyay ethay ormfay ofyay anotheryay aceray.
DIALOGDATA_VANITYMIRROR_INTRODUCTION_BRANCH_0_DIALOG_2_SELECTION_0	Oodbyegay.
DIALOGDATA_VANITYMIRROR_INTRODUCTION_BRANCH_0_DIALOG_2_SELECTION_1	Illusionyay Onesstay?
DIALOGDATA_VANITYMIRROR_INTRODUCTION_BRANCH_0_DIALOG_2_SELECTION_2	Equipmentyay Anityvay?
DIALOGDATA_VANITYMIRROR_INTRODUCTION_BRANCH_0_DIALOG_2_SELECTION_3	Eerpay intoyay ethay Irrormay.
DIALOGDATA_VIVIAN_NAME_TAG	Ivianvay
DIALOGDATA_VIVIAN_BRANCH_0_DIALOG_0_INPUT	
DIALOGDATA_VIVIAN_BRANCH_0_DIALOG_0_INPUT_ALT_0	Hmyay, eahyay?
DIALOGDATA_VIVIAN_BRANCH_0_DIALOG_0_INPUT_ALT_1	Eahyay? At'swhay upyay?
DIALOGDATA_VIVIAN_BRANCH_0_DIALOG_0_INPUT_ALT_2	Ehmyay, ouyay eednay omesay enchantingyay oneday?
DIALOGDATA_VIVIAN_BRANCH_0_DIALOG_0_INPUT_ALT_3	Eyhay! On'tday artlestay emay ikelay atthay. Eezegay.
DIALOGDATA_VIVIAN_BRANCH_0_DIALOG_0_SELECTION_0	Evermindnay.
DIALOGDATA_VIVIAN_BRANCH_0_DIALOG_0_SELECTION_1	Aboutyay omethingsay...
DIALOGDATA_VIVIAN_BRANCH_0_DIALOG_0_SELECTION_2	Enchantyay myyay uffstay!
DIALOGDATA_VIVIAN_BRANCH_1_DIALOG_0_INPUT	
DIALOGDATA_VIVIAN_BRANCH_1_DIALOG_0_INPUT_ALT_0	Alrightyay, opehay ouyay otgay ethay undsfay.
DIALOGDATA_VIVIAN_BRANCH_1_DIALOG_0_INPUT_ALT_1	Myyay ervicessay aren'tyay eapchay, osay inkthay ardhay.
DIALOGDATA_VIVIAN_BRANCH_1_DIALOG_0_INPUT_ALT_2	Hmyay? Ohyay ightray, eway ancay oday atthay.
DIALOGDATA_VIVIAN_BRANCH_1_DIALOG_0_INPUT_ALT_3	Isthay etterbay ebay omethingsay ewnay orfay emay otay enchantyay...
DIALOGDATA_VIVIAN_BRANCH_1_DIALOG_0_INPUT_ALT_4	Oookayyay, et'slay oday ityay.
DIALOGDATA_VIVIAN_BRANCH_1_DIALOG_0_SELECTION_0	Eeyasay!
DIALOGDATA_VIVIAN_BRANCH_2_DIALOG_0_INPUT	
DIALOGDATA_VIVIAN_BRANCH_2_DIALOG_0_INPUT_ALT_0	Uhmyay, eahyay?
DIALOGDATA_VIVIAN_BRANCH_2_DIALOG_0_INPUT_ALT_1	Onay upidstay uestionsqay, easeplay...
DIALOGDATA_VIVIAN_BRANCH_2_DIALOG_0_INPUT_ALT_2	Isyay ityay aboutyay enchantingyay?
DIALOGDATA_VIVIAN_BRANCH_2_DIALOG_0_INPUT_ALT_3	Okayyay, I'myay isteninglay.
DIALOGDATA_VIVIAN_BRANCH_2_DIALOG_0_SELECTION_0	Evermindnay.
DIALOGDATA_VIVIAN_BRANCH_2_DIALOG_0_SELECTION_1	Ou'reyay utecay!
DIALOGDATA_VIVIAN_BRANCH_2_DIALOG_0_SELECTION_2	Apprenticeyay?
DIALOGDATA_VIVIAN_BRANCH_2_DIALOG_0_SELECTION_3	Enchantingyay?
DIALOGDATA_VIVIAN_BRANCH_2_DIALOG_0_SELECTION_4	Eaponway Alingscay?
DIALOGDATA_VIVIAN_BRANCH_3_DIALOG_0_INPUT	Okayyay, osay isthay isyay owhay enchantingyay orksway.
DIALOGDATA_VIVIAN_BRANCH_3_DIALOG_1_INPUT	Ouyay ivegay emay ayay iecepay ofyay equipmentyay. Eaponsway oryay armoryay ancay oday.
DIALOGDATA_VIVIAN_BRANCH_3_DIALOG_2_INPUT	Ependingday onyay ethay equipmentyay, it'llyay ostcay ownscray. Areray itemsyay illway additionallyyay eednay adetray itemsyay otay enchantyay.
DIALOGDATA_VIVIAN_BRANCH_3_DIALOG_3_INPUT	Akemay uresay ethay equipmentyay isn'tyay ormallyfay exoticyay oughthay, Iyay an'tcay enchantyay osethay.
DIALOGDATA_VIVIAN_BRANCH_3_DIALOG_4_INPUT	Enchantingyay isyay ayay elicateday ocesspray, andyay it'syay earlynay impossibleyay otay oosechay ichwhay oneyay ouyay antway.
DIALOGDATA_VIVIAN_BRANCH_3_DIALOG_5_INPUT	Ecausebay ofyay atthay, ouyay illway etgay ayay andomray enchantmentyay eachyay imetay.
DIALOGDATA_VIVIAN_BRANCH_3_DIALOG_6_INPUT	Iyay opehay ouyay understoodyay allyay atthay. Iyay ouldway atherray otnay ivegay ouyay ethay un-downray againyay.
DIALOGDATA_VIVIAN_BRANCH_3_DIALOG_6_SELECTION_0	Anksthay, eeyasay!
DIALOGDATA_VIVIAN_BRANCH_3_DIALOG_6_SELECTION_1	I'llyay enchantyay omethingsay.
DIALOGDATA_VIVIAN_BRANCH_4_DIALOG_0_INPUT	
DIALOGDATA_VIVIAN_BRANCH_4_DIALOG_0_INPUT_ALT_0	Ughyay, utshay upyay...
DIALOGDATA_VIVIAN_BRANCH_4_DIALOG_0_INPUT_ALT_1	Eahyay, at'sthay otnay ayay uestionqay.
DIALOGDATA_VIVIAN_BRANCH_4_DIALOG_0_INPUT_ALT_2	Ouyay uresay aboutyay atthay? Ouyay ightmay otnay ebay ayingsay atthay afteryay Iyay ickkay ouryay acefay inyay.
DIALOGDATA_VIVIAN_BRANCH_4_DIALOG_0_INPUT_ALT_3	Ouyay owknay, omesay ingsthay areyay ustjay etterbay offyay eingbay unsaidyay.
DIALOGDATA_VIVIAN_BRANCH_4_DIALOG_0_INPUT_ALT_4	Eepkay ityay otay ourselfyay, uddybay.
DIALOGDATA_VIVIAN_BRANCH_5_DIALOG_0_INPUT	Epyay, I'myay Angela'syay apprenticeyay. Ayay Icmystay, artpay ofyay erhay udiesstay.
DIALOGDATA_VIVIAN_BRANCH_5_DIALOG_1_INPUT	I'veyay anchedbray offyay otay udystay oremay onyay enchantingyay atherray anthay udyingstay offensiveyay agicmay.
DIALOGDATA_VIVIAN_BRANCH_5_DIALOG_2_INPUT	Iyay inkthay it'syay oremay illchay. Ityay akesmay oodgay ashcay ootay, enwhay ingsthay ogay ellway anywaysyay.
DIALOGDATA_VIVIAN_BRANCH_5_DIALOG_3_INPUT	Iyay espectray Angelayay. Ifyay ityay eren'tway orfay erhay, Iyay ouldn'tway ebay erehay. Ouyay ouldshay espectray erhay ootay.
DIALOGDATA_VIVIAN_BRANCH_6_DIALOG_0_INPUT	Ightray. Osay, ifyay ouyay utpay anyay equippableyay eaponway intoyay ethay enchantingyay otslay, ouyay ancay angechay ethay amageday alescay ofyay ityay.
DIALOGDATA_VIVIAN_BRANCH_6_DIALOG_1_INPUT	Ependingday onyay atwhay ouyay annaway oday, ou'reyay onnagay eednay omesay onesstay otay oday isthay ortsay ofyay ingthay.
DIALOGDATA_VIVIAN_BRANCH_6_DIALOG_2_INPUT	Orfay Engthstray, ou'llyay eednay Ightmay Onesstay.
DIALOGDATA_VIVIAN_BRANCH_6_DIALOG_3_INPUT	Exterityday illway eednay Agilityyay Onesstay.
DIALOGDATA_VIVIAN_BRANCH_6_DIALOG_4_INPUT	Astlylay, Indmay equiresray Uxflay Onesstay. Otgay ityay? Anywaysyay...
DIALOGDATA_VIVIAN_BRANCH_6_DIALOG_5_INPUT	Ifyay ethay eaponway isyay inheritedyay otay ethay alescay ouyay antway, enthay ityay on'tway ostcay anyyay onesstay. Oolcay, ightray?
DIALOGDATA_VIVIAN_BRANCH_6_DIALOG_6_INPUT	Ethay onesstay ancay ebay oundfay aroundyay ethay orldway, utbay eythay ancay alsoyay ebay oldsay omfray endorsvay ootay.
DIALOGDATA_VIVIAN_BRANCH_6_DIALOG_7_INPUT	Ethay onesstay areyay icypray, osay Iyay on'tway eapchay outyay onyay ouyay andyay addyay oremay otay ethay ostcay. Osay... ou'reyay elcomeway.
DIALOGDATA_VIVIAN_INTRODUCTION_BRANCH_0_DIALOG_0_INPUT	Hmyay? Ohyay eyhay. At'swhay upyay?
DIALOGDATA_VIVIAN_INTRODUCTION_BRANCH_0_DIALOG_1_INPUT	I'myay Ivianvay, Angela'syay apprenticeyay.
DIALOGDATA_VIVIAN_INTRODUCTION_BRANCH_0_DIALOG_2_INPUT	Myyay ecalityspay isyay enchantingyay eaponsway andyay armoryay.
DIALOGDATA_VIVIAN_INTRODUCTION_BRANCH_0_DIALOG_3_INPUT	Ifyay ouyay otgay omesay ashcay, Iyay ancay obablypray elphay ouyay outyay. Ustjay askyay icelynay.
DIALOGDATA_VIVIAN_INTRODUCTION_BRANCH_0_DIALOG_4_INPUT	Ooosay... at'swhay ityay onnagay ebay? Ouyay interestedyay inyay myyay ervicessay?
DIALOGDATA_VIVIAN_INTRODUCTION_BRANCH_0_DIALOG_4_SELECTION_0	Aybemay aterlay.
DIALOGDATA_VIVIAN_INTRODUCTION_BRANCH_0_DIALOG_4_SELECTION_1	Ouyay etbay!
DIALOGDATA_DUNGEONPORTAL_NAME_TAG	
DIALOGDATA_DUNGEONPORTAL_BRANCH_0_DIALOG_0_INPUT	Atwhay isyay ouryay estinyday?
DIALOGDATA_DUNGEONPORTAL_BRANCH_0_DIALOG_0_SELECTION_0	Ancelcay
DIALOGDATA_DUNGEONPORTAL_INTRODUCTION_BRANCH_0_DIALOG_0_INPUT	Ethay ortalpay eminatesyay anyay evilyay owerpay! It'syay unlikeyay anyyay otheryay ortalpay ou'veyay eensay eforebay.
DIALOGDATA_DUNGEONPORTAL_INTRODUCTION_BRANCH_0_DIALOG_1_INPUT	Atwhay isyay ouryay estinyday?
DIALOGDATA_DUNGEONPORTAL_INTRODUCTION_BRANCH_0_DIALOG_1_SELECTION_0	Ancelcay
ITEM_RARITY_COMMON	Ommoncay
ITEM_RARITY_RARE	Areray
ITEM_RARITY_EXOTIC	Exoticyay
ITEM_RARITY_LEGENDARY	Egendarylay
ITEM_RARITY_COSMETIC	Osmeticcay
DAMAGE_TYPE_STRENGTH	Engthstray
DAMAGE_TYPE_DEXTERITY	Exterityday
DAMAGE_TYPE_MIND	Indmay
DAMAGE_TYPE_PURE	Urepay
DIALOGDATA_SANCTUMCIVILIAN_00_LOCAL_BRANCH_MAP_HUB_SANCTUM__CLIENTNPCS__NPC_SANCTUMCIVILIAN_RED__DIALOGTRIGGER_DIALOG_0_INPUT	
DIALOGDATA_SANCTUMCIVILIAN_00_LOCAL_BRANCH_MAP_HUB_SANCTUM__CLIENTNPCS__NPC_SANCTUMCIVILIAN_RED__DIALOGTRIGGER_DIALOG_0_INPUT_ALT_0	Engthstray efeatsday ethay eakway! It'syay ayay ownknay actfay atthay Ightersfay avehay ethay upperyay andhay.
DIALOGDATA_SANCTUMCIVILIAN_00_LOCAL_BRANCH_MAP_HUB_SANCTUM__CLIENTNPCS__NPC_SANCTUMCIVILIAN_RED__DIALOGTRIGGER_DIALOG_0_INPUT_ALT_1	Avehay ouyay itnessedway ethay ategystray ofyay Onecyclay? It'syay myyay ifelay onglay oalgay otay earnlay ityay elfmysay!
DIALOGDATA_SANCTUMCIVILIAN_00_LOCAL_BRANCH_MAP_HUB_SANCTUM__CLIENTNPCS__NPC_SANCTUMCIVILIAN_RED__DIALOGTRIGGER_DIALOG_0_INPUT_ALT_2	Enokyay isyay ethay uardiangay Iyay orshipway. Ishay eterminationday andyay alorvay esonatesray ithway emay.
DIALOGDATA_SANCTUMCIVILIAN_00_LOCAL_BRANCH_MAP_HUB_SANCTUM__CLIENTNPCS__NPC_SANCTUMCIVILIAN_BLU_06__DIALOGTRIGGER_DIALOG_0_INPUT	
DIALOGDATA_SANCTUMCIVILIAN_00_LOCAL_BRANCH_MAP_HUB_SANCTUM__CLIENTNPCS__NPC_SANCTUMCIVILIAN_BLU_06__DIALOGTRIGGER_DIALOG_0_INPUT_ALT_0	Iyay opehay otay eesay ethay orldway afesay againyay. Ityay oesn'tday eemsay ikelay at'llthay appenhay.
DIALOGDATA_SANCTUMCIVILIAN_00_LOCAL_BRANCH_MAP_HUB_SANCTUM__CLIENTNPCS__NPC_SANCTUMCIVILIAN_BLU_06__DIALOGTRIGGER_DIALOG_0_INPUT_ALT_1	Oday ouyay inkthay ethay Skyyay Alewhay illstay atchesway usyay?
DIALOGDATA_SANCTUMCIVILIAN_00_LOCAL_BRANCH_MAP_HUB_SANCTUM__CLIENTNPCS__NPC_SANCTUMCIVILIAN_BLU_06__DIALOGTRIGGER_DIALOG_0_INPUT_ALT_2	I'veyay itnessedway ethay Atteringshay. Iyay usedyay otay ivelay inyay ethay Effoldyay Erracetay.
DIALOGDATA_SANCTUMCIVILIAN_00_LOCAL_BRANCH_MAP_HUB_SANCTUM__CLIENTNPCS__NPC_SANCTUMCIVILIAN_BLU_06__DIALOGTRIGGER_DIALOG_0_INPUT_ALT_3	Ighsay...
DIALOGDATA_SANCTUMCIVILIAN_00_LOCAL_BRANCH_MAP_HUB_SANCTUM__CLIENTNPCS__NPC_SANCTUMCIVILIAN_BLU_01__DIALOGTRIGGER_DIALOG_0_INPUT	
DIALOGDATA_SANCTUMCIVILIAN_00_LOCAL_BRANCH_MAP_HUB_SANCTUM__CLIENTNPCS__NPC_SANCTUMCIVILIAN_BLU_01__DIALOGTRIGGER_DIALOG_0_INPUT_ALT_0	Idday ouyay owknay ouyay ancay eathebray underwateryay? It'syay ayay essingblay omfray Angelayay.
DIALOGDATA_SANCTUMCIVILIAN_00_LOCAL_BRANCH_MAP_HUB_SANCTUM__CLIENTNPCS__NPC_SANCTUMCIVILIAN_BLU_01__DIALOGTRIGGER_DIALOG_0_INPUT_ALT_1	Isthay aterway isyay osay urepay. E'reway osay ortunatefay otay avehay ityay.
DIALOGDATA_SANCTUMCIVILIAN_00_LOCAL_BRANCH_MAP_HUB_SANCTUM__CLIENTNPCS__NPC_SANCTUMCIVILIAN_BLU_01__DIALOGTRIGGER_DIALOG_0_INPUT_ALT_2	Isthay isyay ethay Anctumsay Akelay. Eway endtay otay elaxray erehay enwhay imestay areyay oughray.
DIALOGDATA_SANCTUMCIVILIAN_00_LOCAL_BRANCH_MAP_HUB_SANCTUM__CLIENTNPCS__NPC_SANCTUMCIVILIAN_BLU_01__DIALOGTRIGGER_DIALOG_0_INPUT_ALT_3	Hmyay... Iyay onderway atwhay aterway ellsspay areyay outyay erethay.
DIALOGDATA_SANCTUMCIVILIAN_00_LOCAL_BRANCH_MAP_HUB_SANCTUM__CLIENTNPCS__NPC_SANCTUMCIVILIAN_BLU_02__DIALOGTRIGGER_DIALOG_0_INPUT	
DIALOGDATA_SANCTUMCIVILIAN_00_LOCAL_BRANCH_MAP_HUB_SANCTUM__CLIENTNPCS__NPC_SANCTUMCIVILIAN_BLU_02__DIALOGTRIGGER_DIALOG_0_INPUT_ALT_0	Angela'syay itingwray isyay osay ivineday!
DIALOGDATA_SANCTUMCIVILIAN_00_LOCAL_BRANCH_MAP_HUB_SANCTUM__CLIENTNPCS__NPC_SANCTUMCIVILIAN_BLU_02__DIALOGTRIGGER_DIALOG_0_INPUT_ALT_1	I'veyay eenbay acticingpray Uxboltflay. Iyay ancay onlyyay etgay ityay otay ithay ayay ouplecay imestay...
DIALOGDATA_SANCTUMCIVILIAN_00_LOCAL_BRANCH_MAP_HUB_SANCTUM__CLIENTNPCS__NPC_SANCTUMCIVILIAN_BLU_02__DIALOGTRIGGER_DIALOG_0_INPUT_ALT_2	Ethay oundsay ofyay arcaneyay agicmay ingsbray emay oyjay.
DIALOGDATA_SANCTUMCIVILIAN_00_LOCAL_BRANCH_MAP_HUB_SANCTUM__CLIENTNPCS__NPC_SANCTUMCIVILIAN_BLU_02__DIALOGTRIGGER_DIALOG_0_INPUT_ALT_3	Imbueyay isyay ayay eryvay owerfulpay ellspay. Ityay ancay akemay ouryay eleemay eaponsway agicalmay!
DIALOGDATA_SANCTUMCIVILIAN_00_LOCAL_BRANCH_MAP_HUB_SANCTUM__CLIENTNPCS__NPC_SANCTUMCIVILIAN_BLU_03__DIALOGTRIGGER_DIALOG_0_INPUT	
DIALOGDATA_SANCTUMCIVILIAN_00_LOCAL_BRANCH_MAP_HUB_SANCTUM__CLIENTNPCS__NPC_SANCTUMCIVILIAN_BLU_03__DIALOGTRIGGER_DIALOG_0_INPUT_ALT_0	I'myay orrysay, I'myay uiteqay usybay.
DIALOGDATA_SANCTUMCIVILIAN_00_LOCAL_BRANCH_MAP_HUB_SANCTUM__CLIENTNPCS__NPC_SANCTUMCIVILIAN_BLU_03__DIALOGTRIGGER_DIALOG_0_INPUT_ALT_1	Onay imetay otay atchay, I'myay ingtryay otay udystay omethingsay.
DIALOGDATA_SANCTUMCIVILIAN_00_LOCAL_BRANCH_MAP_HUB_SANCTUM__CLIENTNPCS__NPC_SANCTUMCIVILIAN_BLU_03__DIALOGTRIGGER_DIALOG_0_INPUT_ALT_2	...
DIALOGDATA_SANCTUMCIVILIAN_00_LOCAL_BRANCH_MAP_HUB_SANCTUM__CLIENTNPCS__NPC_SANCTUMCIVILIAN_BLU_03__DIALOGTRIGGER_DIALOG_0_INPUT_ALT_3	Hmyay... ohyay? Orrysay, Iyay an'tcay alktay ightray ownay.
DIALOGDATA_SANCTUMCIVILIAN_00_LOCAL_BRANCH_MAP_HUB_SANCTUM__CLIENTNPCS__NPC_SANCTUMCIVILIAN_BLU_04__DIALOGTRIGGER_DIALOG_0_INPUT	
DIALOGDATA_SANCTUMCIVILIAN_00_LOCAL_BRANCH_MAP_HUB_SANCTUM__CLIENTNPCS__NPC_SANCTUMCIVILIAN_BLU_04__DIALOGTRIGGER_DIALOG_0_INPUT_ALT_0	Eetingsgray. Iyay eesay ouyay avehay omecay otay isthay orldway inyay eacepay.
DIALOGDATA_SANCTUMCIVILIAN_00_LOCAL_BRANCH_MAP_HUB_SANCTUM__CLIENTNPCS__NPC_SANCTUMCIVILIAN_BLU_04__DIALOGTRIGGER_DIALOG_0_INPUT_ALT_1	Myyay olleaguecay inksthay ouyay ooklay utecay.
DIALOGDATA_SANCTUMCIVILIAN_00_LOCAL_BRANCH_MAP_HUB_SANCTUM__CLIENTNPCS__NPC_SANCTUMCIVILIAN_BLU_04__DIALOGTRIGGER_DIALOG_0_INPUT_ALT_2	Ere'sthay uchsay ittlelay imetay otay earnlay.
DIALOGDATA_SANCTUMCIVILIAN_00_LOCAL_BRANCH_MAP_HUB_SANCTUM__CLIENTNPCS__NPC_SANCTUMCIVILIAN_BLU_05__DIALOGTRIGGER_DIALOG_0_INPUT	
DIALOGDATA_SANCTUMCIVILIAN_00_LOCAL_BRANCH_MAP_HUB_SANCTUM__CLIENTNPCS__NPC_SANCTUMCIVILIAN_BLU_05__DIALOGTRIGGER_DIALOG_0_INPUT_ALT_0	Ailhay, ostlay oulsay. Oesday isthay aceplay enticeyay ouyay?
DIALOGDATA_SANCTUMCIVILIAN_00_LOCAL_BRANCH_MAP_HUB_SANCTUM__CLIENTNPCS__NPC_SANCTUMCIVILIAN_BLU_05__DIALOGTRIGGER_DIALOG_0_INPUT_ALT_1	Isthay Owertay ingsbray emay olitudesay.
DIALOGDATA_SANCTUMCIVILIAN_00_LOCAL_BRANCH_MAP_HUB_SANCTUM__CLIENTNPCS__NPC_SANCTUMCIVILIAN_BLU_05__DIALOGTRIGGER_DIALOG_0_INPUT_ALT_2	Myyay olleaguecay eemssay otay ikelay ouyay.
DIALOGDATA_SANCTUMCIVILIAN_00_LOCAL_BRANCH_MAP_HUB_SANCTUM__CLIENTNPCS__NPC_SANCTUMCIVILIAN_GRN__DIALOGTRIGGER_DIALOG_0_INPUT	
DIALOGDATA_SANCTUMCIVILIAN_00_LOCAL_BRANCH_MAP_HUB_SANCTUM__CLIENTNPCS__NPC_SANCTUMCIVILIAN_GRN__DIALOGTRIGGER_DIALOG_0_INPUT_ALT_0	Esethay otway on'tday owknay atwhay ityay akestay otay ebay ulytray agileyay. Ifyay onlyyay eythay ewknay...
DIALOGDATA_SANCTUMCIVILIAN_00_LOCAL_BRANCH_MAP_HUB_SANCTUM__CLIENTNPCS__NPC_SANCTUMCIVILIAN_GRN__DIALOGTRIGGER_DIALOG_0_INPUT_ALT_1	Othingnay eatsbay ethay owerpay ofyay itway andyay eedspay. Ightersfay andyay Icsmystay on'tday andstay ayay ancechay againstyay Anditsbay.
DIALOGDATA_SANCTUMCIVILIAN_00_LOCAL_BRANCH_MAP_HUB_SANCTUM__CLIENTNPCS__NPC_SANCTUMCIVILIAN_GRN__DIALOGTRIGGER_DIALOG_0_INPUT_ALT_2	Avehay ouyay okenspay otay Allysay? E'sshay emarkableray.
DIALOGDATA_SANCTUMCIVILIAN_00_LOCAL_BRANCH_MAP_HUB_SANCTUM__CLIENTNPCS__NPC_SANCTUMCIVILIAN_BLU__DIALOGTRIGGER_DIALOG_0_INPUT	
DIALOGDATA_SANCTUMCIVILIAN_00_LOCAL_BRANCH_MAP_HUB_SANCTUM__CLIENTNPCS__NPC_SANCTUMCIVILIAN_BLU__DIALOGTRIGGER_DIALOG_0_INPUT_ALT_0	Ityay isyay uiteqay earclay atthay ethay ayway ofyay ethay Icmystay isyay arfay oremay uperiorsay anthay ethay othersyay.
DIALOGDATA_SANCTUMCIVILIAN_00_LOCAL_BRANCH_MAP_HUB_SANCTUM__CLIENTNPCS__NPC_SANCTUMCIVILIAN_BLU__DIALOGTRIGGER_DIALOG_0_INPUT_ALT_1	Ellcastingspay isyay ethay etterbay optionyay, erethay areyay onay exceptionsyay!
DIALOGDATA_SANCTUMCIVILIAN_00_LOCAL_BRANCH_MAP_HUB_SANCTUM__CLIENTNPCS__NPC_SANCTUMCIVILIAN_BLU__DIALOGTRIGGER_DIALOG_0_INPUT_ALT_2	Angelayay owsknay estbay, andyay e'sshay ethay oneyay atthay owsknay oremay anthay ethay othersyay.
DIALOGDATA_SANCTUMCIVILIAN_00_LOCAL_BRANCH_MAP_HUB_SANCTUM__CLIENTNPCS__NPC_SANCTUMCIVILIAN_BLU__DIALOGTRIGGER_DIALOG_0_INPUT_ALT_3	Iyay avehay uiteqay ayay otlay ofyay ingsthay otay udystay oonsay...
DIALOGDATA_SANCTUMCIVILIAN_00_LOCAL_BRANCH_MAP_HUB_SANCTUM__CLIENTNPCS__NPC_SANCTUMCIVILIAN_RED_08__DIALOGTRIGGER_DIALOG_0_INPUT	
DIALOGDATA_SANCTUMCIVILIAN_00_LOCAL_BRANCH_MAP_HUB_SANCTUM__CLIENTNPCS__NPC_SANCTUMCIVILIAN_RED_08__DIALOGTRIGGER_DIALOG_0_INPUT_ALT_0	Eyahay, elcomeway otay ethay Arracksbay!
DIALOGDATA_SANCTUMCIVILIAN_00_LOCAL_BRANCH_MAP_HUB_SANCTUM__CLIENTNPCS__NPC_SANCTUMCIVILIAN_RED_08__DIALOGTRIGGER_DIALOG_0_INPUT_ALT_1	Ou'veyay etmay Enokyay, orrectcay? Ehay isyay ethay Ighterfay Uardiangay.
DIALOGDATA_SANCTUMCIVILIAN_00_LOCAL_BRANCH_MAP_HUB_SANCTUM__CLIENTNPCS__NPC_SANCTUMCIVILIAN_RED_08__DIALOGTRIGGER_DIALOG_0_INPUT_ALT_2	Myyay engthstray ommunescay ithway Enok'syay owerspay.
DIALOGDATA_SANCTUMCIVILIAN_00_LOCAL_BRANCH_MAP_HUB_SANCTUM__CLIENTNPCS__NPC_SANCTUMCIVILIAN_RED_02__DIALOGTRIGGER_DIALOG_0_INPUT	
DIALOGDATA_SANCTUMCIVILIAN_00_LOCAL_BRANCH_MAP_HUB_SANCTUM__CLIENTNPCS__NPC_SANCTUMCIVILIAN_RED_02__DIALOGTRIGGER_DIALOG_0_INPUT_ALT_0	Ihay erethay!
DIALOGDATA_SANCTUMCIVILIAN_00_LOCAL_BRANCH_MAP_HUB_SANCTUM__CLIENTNPCS__NPC_SANCTUMCIVILIAN_RED_02__DIALOGTRIGGER_DIALOG_0_INPUT_ALT_1	Iyay eesay ou'reyay otnay omfray isthay orldway. E'reway ativesnay erehay. Ostlay oulssay areyay alwaysyay elcomeway.
DIALOGDATA_SANCTUMCIVILIAN_00_LOCAL_BRANCH_MAP_HUB_SANCTUM__CLIENTNPCS__NPC_SANCTUMCIVILIAN_RED_02__DIALOGTRIGGER_DIALOG_0_INPUT_ALT_2	Asyay onglay asyay ouyay assistyay usyay inyay isthay ireday imetay, ou'reyay eefray otay estray erehay!
DIALOGDATA_SANCTUMCIVILIAN_00_LOCAL_BRANCH_MAP_HUB_SANCTUM__CLIENTNPCS__NPC_SANCTUMCIVILIAN_RED_07__DIALOGTRIGGER_DIALOG_0_INPUT	
DIALOGDATA_SANCTUMCIVILIAN_00_LOCAL_BRANCH_MAP_HUB_SANCTUM__CLIENTNPCS__NPC_SANCTUMCIVILIAN_RED_07__DIALOGTRIGGER_DIALOG_0_INPUT_ALT_0	Elcomeway otay ethay Arracksbay, adventureryay.
DIALOGDATA_SANCTUMCIVILIAN_00_LOCAL_BRANCH_MAP_HUB_SANCTUM__CLIENTNPCS__NPC_SANCTUMCIVILIAN_RED_07__DIALOGTRIGGER_DIALOG_0_INPUT_ALT_1	Astermay Enokyay owsknay ofyay ouryay esencepray. On'tday isappointday imhay.
DIALOGDATA_SANCTUMCIVILIAN_00_LOCAL_BRANCH_MAP_HUB_SANCTUM__CLIENTNPCS__NPC_SANCTUMCIVILIAN_RED_07__DIALOGTRIGGER_DIALOG_0_INPUT_ALT_2	Ifyay onlyyay Iyay ouldcay illkay omesay imesslay ightray ownay...
DIALOGDATA_SANCTUMCIVILIAN_00_LOCAL_BRANCH_MAP_HUB_SANCTUM__CLIENTNPCS__NPC_SANCTUMCIVILIAN_RED_04__DIALOGTRIGGER_DIALOG_0_INPUT	
DIALOGDATA_SANCTUMCIVILIAN_00_LOCAL_BRANCH_MAP_HUB_SANCTUM__CLIENTNPCS__NPC_SANCTUMCIVILIAN_RED_04__DIALOGTRIGGER_DIALOG_0_INPUT_ALT_0	It'syay angerousday outyay erethay. I'dyay adviseyay ouyay otay ebay eparedpray.
DIALOGDATA_SANCTUMCIVILIAN_00_LOCAL_BRANCH_MAP_HUB_SANCTUM__CLIENTNPCS__NPC_SANCTUMCIVILIAN_RED_04__DIALOGTRIGGER_DIALOG_0_INPUT_ALT_1	Inyay asecay ifyay ouyay on'tday owknay, ethay ortalpay otay ethay outeryay anctumsay opensyay enwhay ouyay avehay okenspay otay Angelayay.
DIALOGDATA_SANCTUMCIVILIAN_00_LOCAL_BRANCH_MAP_HUB_SANCTUM__CLIENTNPCS__NPC_SANCTUMCIVILIAN_RED_04__DIALOGTRIGGER_DIALOG_0_INPUT_ALT_2	Ifyay onlyyay ethay outsideyay orldway asway afesay ikelay ityay onceyay asway...
DIALOGDATA_SANCTUMCIVILIAN_00_LOCAL_BRANCH_MAP_HUB_SANCTUM__CLIENTNPCS__NPC_SANCTUMCIVILIAN_RED_01__DIALOGTRIGGER_DIALOG_0_INPUT	
DIALOGDATA_SANCTUMCIVILIAN_00_LOCAL_BRANCH_MAP_HUB_SANCTUM__CLIENTNPCS__NPC_SANCTUMCIVILIAN_RED_01__DIALOGTRIGGER_DIALOG_0_INPUT_ALT_0	Eway tryyay otay eepkay Anctumsay ockedstay ithway allyay ethay essentialsyay.
DIALOGDATA_SANCTUMCIVILIAN_00_LOCAL_BRANCH_MAP_HUB_SANCTUM__CLIENTNPCS__NPC_SANCTUMCIVILIAN_RED_01__DIALOGTRIGGER_DIALOG_0_INPUT_ALT_1	Owhay anymay unbagsbay oday eway avehay eftlay? Iyay ostlay ountcay...
DIALOGDATA_SANCTUMCIVILIAN_00_LOCAL_BRANCH_MAP_HUB_SANCTUM__CLIENTNPCS__NPC_SANCTUMCIVILIAN_RED_01__DIALOGTRIGGER_DIALOG_0_INPUT_ALT_2	Hmmyay... Iyay ouldshay alktay otay Allysay ustjay otay akemay uresay eway avehay everythingyay...
DIALOGDATA_SANCTUMCIVILIAN_00_LOCAL_BRANCH_MAP_HUB_SANCTUM__CLIENTNPCS__NPC_SANCTUMCIVILIAN_RED_01__DIALOGTRIGGER_DIALOG_0_INPUT_ALT_3	Aghyay, eway eemsay otay ebay owlay onyay arrotcay akecay. Iyay ovelay atthay uffstay!
DIALOGDATA_SANCTUMCIVILIAN_00_LOCAL_BRANCH_MAP_HUB_SANCTUM__CLIENTNPCS__NPC_SANCTUMCIVILIAN_RED_03__DIALOGTRIGGER_DIALOG_0_INPUT	
DIALOGDATA_SANCTUMCIVILIAN_00_LOCAL_BRANCH_MAP_HUB_SANCTUM__CLIENTNPCS__NPC_SANCTUMCIVILIAN_RED_03__DIALOGTRIGGER_DIALOG_0_INPUT_ALT_0	Iyahay, avellertray!
DIALOGDATA_SANCTUMCIVILIAN_00_LOCAL_BRANCH_MAP_HUB_SANCTUM__CLIENTNPCS__NPC_SANCTUMCIVILIAN_RED_03__DIALOGTRIGGER_DIALOG_0_INPUT_ALT_1	I'veyay otgay omesay ainingtray otay oday, Iyay annaway eatbay upyay omesay imesslay!
DIALOGDATA_SANCTUMCIVILIAN_00_LOCAL_BRANCH_MAP_HUB_SANCTUM__CLIENTNPCS__NPC_SANCTUMCIVILIAN_RED_03__DIALOGTRIGGER_DIALOG_0_INPUT_ALT_2	E'reway otnay ongstray enoughyay otay aketay onyay ethay orldway outsideyay, utbay Iyay annaway ovepray atthay ongwray omedaysay.
DIALOGDATA_SANCTUMCIVILIAN_00_LOCAL_BRANCH_MAP_HUB_SANCTUM__CLIENTNPCS__NPC_SANCTUMCIVILIAN_RED_03__DIALOGTRIGGER_DIALOG_0_INPUT_ALT_3	Etweenbay ouyay andyay emay, Iyay an'tcay aitway otay ickkay isthay uysgay assyay!
DIALOGDATA_SANCTUMCIVILIAN_00_LOCAL_BRANCH_MAP_HUB_SANCTUM__CLIENTNPCS__NPC_SANCTUMCIVILIAN_RED_03__DIALOGTRIGGER_DIALOG_0_INPUT_ALT_4	Atwhay? Ou'veyay ivedlay inyay ayay orldway atthay isn'tyay alwaysyay overcastyay?
DIALOGDATA_SANCTUMCIVILIAN_00_LOCAL_BRANCH_MAP_HUB_SANCTUM__CLIENTNPCS__NPC_SANCTUMCIVILIAN_RED_06__DIALOGTRIGGER_DIALOG_0_INPUT	
DIALOGDATA_SANCTUMCIVILIAN_00_LOCAL_BRANCH_MAP_HUB_SANCTUM__CLIENTNPCS__NPC_SANCTUMCIVILIAN_RED_06__DIALOGTRIGGER_DIALOG_0_INPUT_ALT_0	Ailhay, adventureryay. Isthay isyay ethay atewaygay otay ethay Outeryay Anctumsay.
DIALOGDATA_SANCTUMCIVILIAN_00_LOCAL_BRANCH_MAP_HUB_SANCTUM__CLIENTNPCS__NPC_SANCTUMCIVILIAN_RED_06__DIALOGTRIGGER_DIALOG_0_INPUT_ALT_1	I'myay ationedstay erehay otay uardgay Anctumsay inyay asecay anythingyay omescay oughthray.
DIALOGDATA_SANCTUMCIVILIAN_00_LOCAL_BRANCH_MAP_HUB_SANCTUM__CLIENTNPCS__NPC_SANCTUMCIVILIAN_RED_06__DIALOGTRIGGER_DIALOG_0_INPUT_ALT_2	Hmyay... owhay anymay anceschay avehay ouyay adhay otay ovepray ourselfyay eyondbay isthay orldway?
DIALOGDATA_SANCTUMCIVILIAN_00_LOCAL_BRANCH_MAP_HUB_SANCTUM__CLIENTNPCS__NPC_SANCTUMCIVILIAN_GRN_01__DIALOGTRIGGER_DIALOG_0_INPUT	
DIALOGDATA_SANCTUMCIVILIAN_00_LOCAL_BRANCH_MAP_HUB_SANCTUM__CLIENTNPCS__NPC_SANCTUMCIVILIAN_GRN_01__DIALOGTRIGGER_DIALOG_0_INPUT_ALT_0	Iyay oday onderway atwhay otheryay aceplay outyay erethay inyay isthay orldway isyay asyay afesay asyay erehay...
DIALOGDATA_SANCTUMCIVILIAN_00_LOCAL_BRANCH_MAP_HUB_SANCTUM__CLIENTNPCS__NPC_SANCTUMCIVILIAN_GRN_01__DIALOGTRIGGER_DIALOG_0_INPUT_ALT_1	Avehay ouyay eenbay otay ethay Escentcray Eepkay? Umorray ashay ityay atthay ityay asway onceyay ayay empletay ofyay aturenay agicmay.
DIALOGDATA_SANCTUMCIVILIAN_00_LOCAL_BRANCH_MAP_HUB_SANCTUM__CLIENTNPCS__NPC_SANCTUMCIVILIAN_GRN_01__DIALOGTRIGGER_DIALOG_0_INPUT_ALT_2	Ethay Uardiansgay eemsay otay avehay edatedpray ouryay existanceyay, utbay i'veyay eenbay oldtay isthay isn'tyay uetray.
DIALOGDATA_SANCTUMCIVILIAN_00_LOCAL_BRANCH_MAP_HUB_SANCTUM__CLIENTNPCS__NPC_SANCTUMCIVILIAN_GRN_01__DIALOGTRIGGER_DIALOG_0_INPUT_ALT_3	Iyay onderway at'swhay orfay innerday...
DIALOGDATA_SANCTUMCIVILIAN_00_LOCAL_BRANCH_MAP_HUB_WALLOFTHESTARS__LOCALNPC__NPC_SANCTUMCIVILIAN_BLU__DIALOGTRIGGER_DIALOG_0_INPUT	
DIALOGDATA_SANCTUMCIVILIAN_00_LOCAL_BRANCH_MAP_HUB_WALLOFTHESTARS__LOCALNPC__NPC_SANCTUMCIVILIAN_BLU__DIALOGTRIGGER_DIALOG_0_INPUT_ALT_0	It'syay ootay ovelylay erehay orfay emay otay eavelay. I'llyay ebay ayingstay erehay.
DIALOGDATA_SANCTUMCIVILIAN_00_LOCAL_BRANCH_MAP_HUB_WALLOFTHESTARS__LOCALNPC__NPC_SANCTUMCIVILIAN_BLU__DIALOGTRIGGER_DIALOG_0_INPUT_ALT_1	Idday ouyay openyay ethay ortalpay eadinglay erehay?
DIALOGDATA_SANCTUMCIVILIAN_00_LOCAL_BRANCH_MAP_HUB_WALLOFTHESTARS__LOCALNPC__NPC_SANCTUMCIVILIAN_BLU__DIALOGTRIGGER_DIALOG_0_INPUT_ALT_2	Essedblay ayday, Angelayay ashay otnay orgottenfay usyay!
DIALOGDATA_SANCTUMCIVILIAN_00_LOCAL_BRANCH_MAP_HUB_WALLOFTHESTARS__LOCALNPC__NPC_SANCTUMCIVILIAN_RED_04__DIALOGTRIGGER_DIALOG_0_INPUT	
DIALOGDATA_SANCTUMCIVILIAN_00_LOCAL_BRANCH_MAP_HUB_WALLOFTHESTARS__LOCALNPC__NPC_SANCTUMCIVILIAN_RED_04__DIALOGTRIGGER_DIALOG_0_INPUT_ALT_0	Ohyay? Iyay oughtthay i'dyay evernay eesay anyoneyay ewnay erehay.
DIALOGDATA_SANCTUMCIVILIAN_00_LOCAL_BRANCH_MAP_HUB_WALLOFTHESTARS__LOCALNPC__NPC_SANCTUMCIVILIAN_RED_04__DIALOGTRIGGER_DIALOG_0_INPUT_ALT_1	Ityay eemssay ethay ortalpay isyay openedyay erehay ownay... ankthay oodnessgay!
DIALOGDATA_SANCTUMCIVILIAN_00_LOCAL_BRANCH_MAP_HUB_WALLOFTHESTARS__LOCALNPC__NPC_SANCTUMCIVILIAN_RED_04__DIALOGTRIGGER_DIALOG_0_INPUT_ALT_2	Easeplay estray erehay eforebay oinggay ackbay outyay, andyay ebay arefulcay!
DIALOGDATA_SANCTUMCIVILIAN_00_LOCAL_BRANCH_MAP_HUB_WALLOFTHESTARS__LOCALNPC__NPC_SANCTUMCIVILIAN_RED_04__DIALOGTRIGGER_DIALOG_0_INPUT_ALT_3	Owhay isyay Anctumsay? Iyay opehay ingsthay areyay okayyay erethay.
DIALOGDATA_SANCTUMCIVILIAN_00_LOCAL_BRANCH_MAP_HUB_WALLOFTHESTARS__LOCALNPC__NPC_SANCTUMCIVILIAN_GRN__DIALOGTRIGGER_DIALOG_0_INPUT	
DIALOGDATA_SANCTUMCIVILIAN_00_LOCAL_BRANCH_MAP_HUB_WALLOFTHESTARS__LOCALNPC__NPC_SANCTUMCIVILIAN_GRN__DIALOGTRIGGER_DIALOG_0_INPUT_ALT_0	Omesay aysay ethay Allway ofyay ethay Arsstay ancay eakspay ithinway ouryay indmay.
DIALOGDATA_SANCTUMCIVILIAN_00_LOCAL_BRANCH_MAP_HUB_WALLOFTHESTARS__LOCALNPC__NPC_SANCTUMCIVILIAN_GRN__DIALOGTRIGGER_DIALOG_0_INPUT_ALT_1	It'syay oodgay otay owknay e'reway otnay andedstray erehay anymoreyay...
DIALOGDATA_SANCTUMCIVILIAN_00_LOCAL_BRANCH_MAP_HUB_WALLOFTHESTARS__LOCALNPC__NPC_SANCTUMCIVILIAN_GRN__DIALOGTRIGGER_DIALOG_0_INPUT_ALT_2	E'reway osay ortunatefay otay avehay eenbay uckstay erehay atherray anthay omewheresay angerousday...
DIALOGDATA_SANCTUMCIVILIAN_00_LOCAL_BRANCH_MAP_HUB_WALLOFTHESTARS__LOCALNPC__NPC_SANCTUMCIVILIAN_GRN__DIALOGTRIGGER_DIALOG_0_INPUT_ALT_3	Ellohay, avelertray.
